﻿Codi Província;Nom Província;Codi Vegueria;Nom Vegueria;Codi Comarca;Nom Comarca;Codi Municipi;Nom Municipi;Districte;Secció;Població;Cens;Participació 14:00;Participació 18:00;Participació 20:00;Abstenció;Vots nuls;Vots en blanc;Vots a candidatures;Vots vàlids
25;Lleida;5;Alt Pirineu i territori d'Aran;25;Pallars Jussà;25001;Abella de la Conca;1;1;;146;58;85;122;24;0;0;122;122
8;Barcelona;1;Barcelona;11;Baix Llobregat;08001;Abrera;1;1;;1141;440;600;768;373;2;5;761;766
8;Barcelona;1;Barcelona;11;Baix Llobregat;08001;Abrera;1;2;;1279;533;697;859;420;6;5;848;853
8;Barcelona;1;Barcelona;11;Baix Llobregat;08001;Abrera;1;3;;574;209;307;391;183;0;1;390;391
8;Barcelona;1;Barcelona;11;Baix Llobregat;08001;Abrera;1;4;;1371;461;671;903;468;3;4;896;900
8;Barcelona;1;Barcelona;11;Baix Llobregat;08001;Abrera;1;5;;1404;519;724;893;511;1;4;888;892
8;Barcelona;1;Barcelona;11;Baix Llobregat;08001;Abrera;1;7;;1901;549;813;1074;827;4;12;1058;1070
8;Barcelona;1;Barcelona;11;Baix Llobregat;08001;Abrera;1;8;;1430;494;724;972;458;0;1;971;972
25;Lleida;4;Lleida;23;Noguera;25002;Àger;1;1;;490;225;323;410;80;2;16;392;408
25;Lleida;4;Lleida;38;Urgell;25003;Agramunt;1;1;;577;203;288;378;199;4;18;356;374
25;Lleida;4;Lleida;38;Urgell;25003;Agramunt;1;2;;649;222;318;424;225;4;26;394;420
25;Lleida;4;Lleida;38;Urgell;25003;Agramunt;1;3;;1350;446;650;899;451;24;31;844;875
25;Lleida;4;Lleida;38;Urgell;25003;Agramunt;1;4;;1198;418;590;794;404;18;44;732;776
8;Barcelona;2;Catalunya Central;7;Bages;08002;Aguilar de Segarra;1;1;;221;74;139;191;30;5;3;183;186
17;Girona;3;Girona;2;Alt Empordà;17001;Agullana;1;1;;600;279;405;470;130;3;12;455;467
8;Barcelona;1;Barcelona;41;Vallès Oriental;08014;Aiguafreda;1;1;;2012;786;1140;1435;577;13;46;1376;1422
43;Tarragona;6;Camp de Tarragona;1;Alt Camp;43001;Aiguamúrcia;1;1;;708;301;419;538;170;4;7;527;534
17;Girona;3;Girona;20;Gironès;17002;Aiguaviva;1;1;;563;286;386;480;83;0;12;468;480
25;Lleida;4;Lleida;33;Segrià;25038;Aitona;1;1;;775;349;500;616;159;0;13;603;616
25;Lleida;4;Lleida;33;Segrià;25038;Aitona;1;2;;757;370;523;638;119;6;11;621;632
25;Lleida;4;Lleida;33;Segrià;25004;Alamús, els;1;1;;602;242;385;488;114;17;22;449;471
25;Lleida;5;Alt Pirineu i territori d'Aran;4;Alt Urgell;25005;Alàs i Cerc;1;1;;271;111;154;198;73;4;2;192;194
25;Lleida;4;Lleida;18;Garrigues;25006;Albagés, l';1;1;;319;181;228;272;47;4;3;265;268
17;Girona;3;Girona;2;Alt Empordà;17003;Albanyà;1;1;;106;43;56;80;26;1;1;78;79
25;Lleida;4;Lleida;33;Segrià;25007;Albatàrrec;1;1;;1416;568;772;1006;410;15;27;964;991
25;Lleida;4;Lleida;23;Noguera;25008;Albesa;1;1;;1106;508;708;872;234;7;18;847;865
25;Lleida;4;Lleida;18;Garrigues;25009;Albi, l';1;1;;606;291;450;544;62;13;11;520;531
43;Tarragona;8;Penedès;12;Baix Penedès;43002;Albinyana;1;1;;1892;796;1102;1373;519;16;11;1346;1357
43;Tarragona;6;Camp de Tarragona;8;Baix Camp;43003;Albiol, l';1;1;;359;167;221;281;78;3;2;276;278
17;Girona;3;Girona;10;Baix Empordà;17004;Albons;1;1;;547;234;311;398;149;18;35;345;380
43;Tarragona;7;Terres de l'Ebre;22;Montsià;43004;Alcanar;1;1;;1098;463;602;775;323;13;12;750;762
43;Tarragona;7;Terres de l'Ebre;22;Montsià;43004;Alcanar;1;2;;1170;438;621;809;361;9;7;793;800
43;Tarragona;7;Terres de l'Ebre;22;Montsià;43004;Alcanar;1;3;;1743;622;821;1061;682;3;9;1049;1058
43;Tarragona;7;Terres de l'Ebre;22;Montsià;43004;Alcanar;1;4;;1151;485;643;876;275;16;18;842;860
43;Tarragona;7;Terres de l'Ebre;22;Montsià;43004;Alcanar;2;1;;925;403;547;650;275;5;7;638;645
43;Tarragona;7;Terres de l'Ebre;22;Montsià;43004;Alcanar;2;2;;523;238;310;367;156;7;3;357;360
25;Lleida;4;Lleida;33;Segrià;25010;Alcanó;1;1;;196;82;119;150;46;7;3;140;143
25;Lleida;4;Lleida;33;Segrià;25011;Alcarràs;1;1;;1647;588;829;1094;553;6;15;1073;1088
25;Lleida;4;Lleida;33;Segrià;25011;Alcarràs;1;2;;1464;480;670;874;590;4;2;868;870
25;Lleida;4;Lleida;33;Segrià;25011;Alcarràs;1;3;;943;304;425;580;363;1;6;573;579
25;Lleida;4;Lleida;33;Segrià;25011;Alcarràs;1;4;;1393;530;829;941;452;5;20;916;936
25;Lleida;4;Lleida;33;Segrià;25012;Alcoletge;1;1;;1361;567;764;977;384;13;9;955;964
25;Lleida;4;Lleida;33;Segrià;25012;Alcoletge;1;2;;1081;299;459;599;482;8;7;584;591
43;Tarragona;6;Camp de Tarragona;1;Alt Camp;43005;Alcover;1;1;;1917;796;1124;1416;501;5;14;1397;1411
43;Tarragona;6;Camp de Tarragona;1;Alt Camp;43005;Alcover;2;1;;1792;619;876;1150;642;6;9;1135;1144
43;Tarragona;7;Terres de l'Ebre;9;Baix Ebre;43904;Aldea, l';1;1;;1638;788;1020;1247;391;26;22;1199;1221
43;Tarragona;7;Terres de l'Ebre;9;Baix Ebre;43904;Aldea, l';1;2;;1239;568;761;928;311;31;24;873;897
43;Tarragona;7;Terres de l'Ebre;9;Baix Ebre;43006;Aldover;1;1;;704;337;489;557;147;8;10;539;549
43;Tarragona;6;Camp de Tarragona;8;Baix Camp;43007;Aleixar, l';1;1;;652;298;422;511;141;6;2;503;505
8;Barcelona;1;Barcelona;21;Maresme;08003;Alella;1;1;;2065;751;1046;1370;695;7;16;1347;1363
8;Barcelona;1;Barcelona;21;Maresme;08003;Alella;1;2;;1831;594;976;1228;603;0;5;1223;1228
8;Barcelona;1;Barcelona;21;Maresme;08003;Alella;1;3;;1728;667;937;1189;539;6;9;1174;1183
8;Barcelona;1;Barcelona;21;Maresme;08003;Alella;1;4;;1687;504;788;1040;647;1;12;1027;1039
43;Tarragona;7;Terres de l'Ebre;9;Baix Ebre;43008;Alfara de Carles;1;1;;311;100;151;211;100;16;18;177;195
25;Lleida;4;Lleida;33;Segrià;25013;Alfarràs;1;1;;1162;451;601;909;253;5;10;894;904
25;Lleida;4;Lleida;33;Segrià;25013;Alfarràs;1;2;;956;374;532;688;268;3;5;680;685
25;Lleida;4;Lleida;33;Segrià;25014;Alfés;1;1;;251;109;153;194;57;9;30;155;185
43;Tarragona;6;Camp de Tarragona;8;Baix Camp;43009;Alforja;1;1;;1405;591;831;1037;368;31;26;980;1006
25;Lleida;4;Lleida;23;Noguera;25015;Algerri;1;1;;338;158;202;245;93;10;28;207;235
25;Lleida;4;Lleida;33;Segrià;25016;Alguaire;1;1;;990;409;546;689;301;8;13;668;681
25;Lleida;4;Lleida;33;Segrià;25016;Alguaire;1;2;;1100;400;591;765;335;8;16;741;757
25;Lleida;5;Alt Pirineu i territori d'Aran;26;Pallars Sobirà;25017;Alins;1;1;;231;75;118;206;25;1;2;203;205
43;Tarragona;6;Camp de Tarragona;1;Alt Camp;43010;Alió;1;1;;334;154;200;249;85;24;16;209;225
25;Lleida;4;Lleida;33;Segrià;25019;Almacelles;1;1;;808;318;433;566;242;9;8;549;557
25;Lleida;4;Lleida;33;Segrià;25019;Almacelles;1;2;;1375;480;674;943;432;11;17;915;932
25;Lleida;4;Lleida;33;Segrià;25019;Almacelles;2;1;;949;312;453;616;333;16;8;592;600
25;Lleida;4;Lleida;33;Segrià;25019;Almacelles;2;2;;1533;512;714;913;620;12;10;891;901
25;Lleida;4;Lleida;33;Segrià;25020;Almatret;1;1;;276;133;179;218;58;10;18;190;208
25;Lleida;4;Lleida;33;Segrià;25021;Almenar;1;1;;587;236;316;384;203;0;1;383;384
25;Lleida;4;Lleida;33;Segrià;25021;Almenar;2;1;;1028;403;562;749;279;3;13;733;746
25;Lleida;4;Lleida;33;Segrià;25021;Almenar;2;2;;930;374;545;693;237;3;13;677;690
43;Tarragona;6;Camp de Tarragona;8;Baix Camp;43011;Almoster;1;1;;1089;397;591;803;286;44;61;698;759
25;Lleida;4;Lleida;23;Noguera;25022;Alòs de Balaguer;1;1;;114;37;58;84;30;1;5;78;83
17;Girona;5;Alt Pirineu i territori d'Aran;15;Cerdanya;17006;Alp;1;1;;1207;448;620;818;389;15;25;778;803
8;Barcelona;2;Catalunya Central;24;Osona;08004;Alpens;1;1;;211;105;149;191;20;2;3;186;189
25;Lleida;4;Lleida;33;Segrià;25023;Alpicat;1;1;;1680;629;864;1153;527;3;21;1129;1150
25;Lleida;4;Lleida;33;Segrià;25023;Alpicat;1;2;;1619;607;848;1132;487;6;14;1112;1126
25;Lleida;4;Lleida;33;Segrià;25023;Alpicat;1;3;;1277;428;589;878;399;6;15;857;872
43;Tarragona;6;Camp de Tarragona;36;Tarragonès;43012;Altafulla;1;1;;948;415;534;658;290;0;3;655;658
43;Tarragona;6;Camp de Tarragona;36;Tarragonès;43012;Altafulla;1;2;;1000;387;488;690;310;3;4;683;687
43;Tarragona;6;Camp de Tarragona;36;Tarragonès;43012;Altafulla;1;3;;1795;764;1059;1379;416;4;13;1362;1375
25;Lleida;5;Alt Pirineu i territori d'Aran;26;Pallars Sobirà;25024;Alt Àneu;1;1;;355;146;206;299;56;2;3;294;297
17;Girona;3;Girona;34;Selva;17007;Amer;1;1;;1760;793;1097;1355;405;88;79;1188;1267
8;Barcelona;1;Barcelona;41;Vallès Oriental;08005;Ametlla del Vallès, l';1;1;;1845;564;881;1182;663;3;17;1162;1179
8;Barcelona;1;Barcelona;41;Vallès Oriental;08005;Ametlla del Vallès, l';1;2;;1340;521;760;945;395;8;12;925;937
8;Barcelona;1;Barcelona;41;Vallès Oriental;08005;Ametlla del Vallès, l';1;3;;1868;643;986;1278;590;12;24;1242;1266
8;Barcelona;1;Barcelona;41;Vallès Oriental;08005;Ametlla del Vallès, l';1;4;;842;270;422;547;295;4;0;543;543
8;Barcelona;1;Barcelona;41;Vallès Oriental;08005;Ametlla del Vallès, l';1;5;;585;197;297;364;221;1;7;356;363
43;Tarragona;7;Terres de l'Ebre;9;Baix Ebre;43013;Ametlla de Mar, l';1;1;;1456;629;844;1059;397;10;22;1027;1049
43;Tarragona;7;Terres de l'Ebre;9;Baix Ebre;43013;Ametlla de Mar, l';1;2;;1048;500;618;780;268;10;8;762;770
43;Tarragona;7;Terres de l'Ebre;9;Baix Ebre;43013;Ametlla de Mar, l';1;3;;2271;867;1110;1408;863;19;14;1375;1389
43;Tarragona;7;Terres de l'Ebre;9;Baix Ebre;43906;Ampolla, l';1;1;;1229;500;707;884;345;25;21;838;859
43;Tarragona;7;Terres de l'Ebre;9;Baix Ebre;43906;Ampolla, l';1;2;;984;491;621;746;238;8;19;719;738
43;Tarragona;7;Terres de l'Ebre;22;Montsià;43014;Amposta;1;1;;569;228;302;390;179;5;4;381;385
43;Tarragona;7;Terres de l'Ebre;22;Montsià;43014;Amposta;1;2;;949;420;531;652;297;6;10;636;646
43;Tarragona;7;Terres de l'Ebre;22;Montsià;43014;Amposta;2;1;;724;312;420;520;204;4;11;505;516
43;Tarragona;7;Terres de l'Ebre;22;Montsià;43014;Amposta;2;2;;643;270;330;412;231;1;2;409;411
43;Tarragona;7;Terres de l'Ebre;22;Montsià;43014;Amposta;3;1;;796;301;439;564;232;2;7;555;562
43;Tarragona;7;Terres de l'Ebre;22;Montsià;43014;Amposta;3;2;;1408;596;794;992;416;5;10;977;987
43;Tarragona;7;Terres de l'Ebre;22;Montsià;43014;Amposta;4;1;;972;444;534;655;317;2;7;646;653
43;Tarragona;7;Terres de l'Ebre;22;Montsià;43014;Amposta;4;2;;1080;475;615;756;324;8;7;741;748
43;Tarragona;7;Terres de l'Ebre;22;Montsià;43014;Amposta;4;3;;1686;694;914;1143;543;5;9;1129;1138
43;Tarragona;7;Terres de l'Ebre;22;Montsià;43014;Amposta;4;4;;1982;803;1089;1431;551;15;21;1395;1416
43;Tarragona;7;Terres de l'Ebre;22;Montsià;43014;Amposta;4;5;;2004;775;1037;1319;685;20;13;1286;1299
43;Tarragona;7;Terres de l'Ebre;22;Montsià;43014;Amposta;4;6;;1748;551;798;1082;666;9;7;1066;1073
17;Girona;3;Girona;34;Selva;17008;Anglès;1;1;;828;305;444;579;249;19;17;543;560
17;Girona;3;Girona;34;Selva;17008;Anglès;1;2;;1615;646;934;1152;463;19;19;1114;1133
17;Girona;3;Girona;34;Selva;17008;Anglès;1;3;;1199;476;693;849;350;2;24;823;847
25;Lleida;4;Lleida;38;Urgell;25027;Anglesola;1;1;;1008;459;661;804;204;7;8;789;797
25;Lleida;4;Lleida;18;Garrigues;25029;Arbeca;1;1;;793;338;453;586;207;5;5;576;581
25;Lleida;4;Lleida;18;Garrigues;25029;Arbeca;1;2;;878;367;548;694;184;5;4;685;689
43;Tarragona;8;Penedès;12;Baix Penedès;43016;Arboç, l';1;1;;1616;654;860;1070;546;12;6;1052;1058
43;Tarragona;8;Penedès;12;Baix Penedès;43016;Arboç, l';1;2;;1985;782;1144;1436;549;15;10;1411;1421
43;Tarragona;6;Camp de Tarragona;8;Baix Camp;43015;Arbolí;1;1;;118;71;87;102;16;0;0;102;102
17;Girona;3;Girona;34;Selva;17009;Arbúcies;1;1;;1542;598;956;1150;392;12;30;1108;1138
17;Girona;3;Girona;34;Selva;17009;Arbúcies;1;2;;1557;692;973;1187;370;17;39;1131;1170
17;Girona;3;Girona;34;Selva;17009;Arbúcies;2;1;;994;449;622;755;239;12;23;720;743
8;Barcelona;1;Barcelona;21;Maresme;08006;Arenys de Mar;1;1;;1848;889;1101;1246;602;6;14;1226;1240
8;Barcelona;1;Barcelona;21;Maresme;08006;Arenys de Mar;1;2;;1742;695;972;1191;551;3;10;1178;1188
8;Barcelona;1;Barcelona;21;Maresme;08006;Arenys de Mar;1;3;;974;376;496;610;364;5;8;597;605
8;Barcelona;1;Barcelona;21;Maresme;08006;Arenys de Mar;1;4;;913;265;409;523;390;2;8;513;521
8;Barcelona;1;Barcelona;21;Maresme;08006;Arenys de Mar;2;1;;1312;512;664;819;493;5;9;805;814
8;Barcelona;1;Barcelona;21;Maresme;08006;Arenys de Mar;2;2;;1447;607;863;1007;440;5;11;991;1002
8;Barcelona;1;Barcelona;21;Maresme;08006;Arenys de Mar;2;3;;1373;521;715;899;474;5;6;888;894
8;Barcelona;1;Barcelona;21;Maresme;08006;Arenys de Mar;2;4;;1013;441;580;593;420;2;1;590;591
8;Barcelona;1;Barcelona;21;Maresme;08006;Arenys de Mar;2;5;;1315;493;649;834;481;4;4;826;830
8;Barcelona;1;Barcelona;21;Maresme;08007;Arenys de Munt;1;1;;1204;467;644;816;388;7;20;789;809
8;Barcelona;1;Barcelona;21;Maresme;08007;Arenys de Munt;1;2;;2307;962;1319;1595;712;17;40;1538;1578
8;Barcelona;1;Barcelona;21;Maresme;08007;Arenys de Munt;2;1;;1616;713;953;1165;451;7;24;1134;1158
8;Barcelona;1;Barcelona;21;Maresme;08007;Arenys de Munt;2;2;;1703;614;848;1059;644;16;39;1004;1043
17;Girona;3;Girona;19;Garrotxa;17010;Argelaguer;1;1;;330;128;182;222;108;14;22;186;208
8;Barcelona;8;Penedès;6;Anoia;08008;Argençola;1;1;;184;90;113;146;38;10;3;133;136
43;Tarragona;6;Camp de Tarragona;8;Baix Camp;43017;Argentera, l';1;1;;119;59;81;99;20;3;11;85;96
8;Barcelona;1;Barcelona;21;Maresme;08009;Argentona;1;1;;660;262;373;481;179;0;15;466;481
8;Barcelona;1;Barcelona;21;Maresme;08009;Argentona;1;2;;1336;583;804;982;354;6;27;949;976
8;Barcelona;1;Barcelona;21;Maresme;08009;Argentona;1;3;;616;268;357;405;211;3;8;394;402
8;Barcelona;1;Barcelona;21;Maresme;08009;Argentona;1;4;;1455;491;684;837;618;4;6;827;833
8;Barcelona;1;Barcelona;21;Maresme;08009;Argentona;1;5;;828;384;529;665;163;3;5;657;662
8;Barcelona;1;Barcelona;21;Maresme;08009;Argentona;1;6;;1647;619;888;1140;507;6;24;1110;1134
8;Barcelona;1;Barcelona;21;Maresme;08009;Argentona;2;1;;958;356;503;629;329;4;9;616;625
8;Barcelona;1;Barcelona;21;Maresme;08009;Argentona;2;2;;1081;436;596;726;355;11;14;701;715
8;Barcelona;1;Barcelona;21;Maresme;08009;Argentona;2;3;;982;407;564;705;277;3;21;681;702
17;Girona;3;Girona;2;Alt Empordà;17011;Armentera, l';1;1;;664;245;397;477;187;43;105;329;434
43;Tarragona;7;Terres de l'Ebre;37;Terra Alta;43018;Arnes;1;1;;385;223;311;355;30;4;0;351;351
25;Lleida;5;Alt Pirineu i territori d'Aran;39;Consell General d'Aran;25031;Arres;1;1;;61;18;20;53;8;1;0;52;52
25;Lleida;5;Alt Pirineu i territori d'Aran;4;Alt Urgell;25032;Arsèguel;1;1;;64;22;31;47;17;0;0;47;47
8;Barcelona;2;Catalunya Central;7;Bages;08010;Artés;1;1;;1032;375;549;703;329;15;18;670;688
8;Barcelona;2;Catalunya Central;7;Bages;08010;Artés;2;1;;1192;436;643;838;354;7;18;813;831
8;Barcelona;2;Catalunya Central;7;Bages;08010;Artés;2;2;;671;220;367;446;225;2;11;433;444
8;Barcelona;2;Catalunya Central;7;Bages;08010;Artés;2;3;;1333;475;767;983;350;25;26;932;958
25;Lleida;4;Lleida;33;Segrià;25033;Artesa de Lleida;1;1;;1124;554;745;907;217;18;14;875;889
25;Lleida;4;Lleida;23;Noguera;25034;Artesa de Segre;1;1;;1353;566;809;998;355;11;44;943;987
25;Lleida;4;Lleida;23;Noguera;25034;Artesa de Segre;1;2;;956;368;550;679;277;9;14;656;670
43;Tarragona;7;Terres de l'Ebre;30;Ribera d'Ebre;43019;Ascó;1;1;;1349;594;891;1134;215;23;8;1103;1111
25;Lleida;4;Lleida;33;Segrià;25036;Aspa;1;1;;184;79;120;152;32;5;1;146;147
25;Lleida;4;Lleida;23;Noguera;25037;Avellanes i Santa Linya, les;1;1;;370;172;242;312;58;5;9;298;307
8;Barcelona;2;Catalunya Central;14;Berguedà;08011;Avià;1;1;;1748;694;1058;1363;385;23;39;1301;1340
8;Barcelona;2;Catalunya Central;7;Bages;08012;Avinyó;1;1;;1732;682;1020;1249;483;54;61;1134;1195
8;Barcelona;8;Penedès;3;Alt Penedès;08013;Avinyonet del Penedès;1;1;;1292;629;829;986;306;8;27;951;978
17;Girona;3;Girona;2;Alt Empordà;17012;Avinyonet de Puigventós;1;1;;1194;356;568;749;445;5;37;707;744
8;Barcelona;1;Barcelona;13;Barcelonès;08015;Badalona;1;1;;1170;479;707;921;249;3;9;909;918
8;Barcelona;1;Barcelona;13;Barcelonès;08015;Badalona;1;2;;978;424;589;715;263;2;9;704;713
8;Barcelona;1;Barcelona;13;Barcelonès;08015;Badalona;1;3;;812;328;481;598;214;3;7;588;595
8;Barcelona;1;Barcelona;13;Barcelonès;08015;Badalona;1;4;;1154;498;705;900;254;2;5;893;898
8;Barcelona;1;Barcelona;13;Barcelonès;08015;Badalona;1;5;;1174;498;739;899;275;3;4;892;896
8;Barcelona;1;Barcelona;13;Barcelonès;08015;Badalona;1;7;;1009;435;581;752;257;2;8;742;750
8;Barcelona;1;Barcelona;13;Barcelonès;08015;Badalona;2;1;;1022;409;549;676;346;2;8;666;674
8;Barcelona;1;Barcelona;13;Barcelonès;08015;Badalona;2;10;;1054;338;457;597;457;1;8;588;596
8;Barcelona;1;Barcelona;13;Barcelonès;08015;Badalona;2;11;;1167;420;592;715;452;0;2;713;715
8;Barcelona;1;Barcelona;13;Barcelonès;08015;Badalona;2;12;;805;280;385;485;320;0;0;485;485
8;Barcelona;1;Barcelona;13;Barcelonès;08015;Badalona;2;13;;842;321;423;506;336;0;2;504;506
8;Barcelona;1;Barcelona;13;Barcelonès;08015;Badalona;2;15;;757;264;359;442;315;0;3;439;442
8;Barcelona;1;Barcelona;13;Barcelonès;08015;Badalona;2;2;;1376;619;857;1072;304;4;5;1063;1068
8;Barcelona;1;Barcelona;13;Barcelonès;08015;Badalona;2;3;;723;290;429;544;179;1;6;537;543
8;Barcelona;1;Barcelona;13;Barcelonès;08015;Badalona;2;4;;1639;655;962;1217;422;3;12;1202;1214
8;Barcelona;1;Barcelona;13;Barcelonès;08015;Badalona;2;5;;931;338;430;553;378;2;0;551;551
8;Barcelona;1;Barcelona;13;Barcelonès;08015;Badalona;2;7;;881;301;433;514;367;0;3;511;514
8;Barcelona;1;Barcelona;13;Barcelonès;08015;Badalona;2;8;;1783;725;1058;1335;448;3;2;1330;1332
8;Barcelona;1;Barcelona;13;Barcelonès;08015;Badalona;2;9;;751;209;310;368;383;0;0;368;368
8;Barcelona;1;Barcelona;13;Barcelonès;08015;Badalona;3;1;;1823;655;980;1239;584;5;10;1224;1234
8;Barcelona;1;Barcelona;13;Barcelonès;08015;Badalona;3;10;;703;308;419;527;176;1;2;524;526
8;Barcelona;1;Barcelona;13;Barcelonès;08015;Badalona;3;11;;942;341;516;667;275;0;5;662;667
8;Barcelona;1;Barcelona;13;Barcelonès;08015;Badalona;3;13;;1151;426;678;863;288;1;3;859;862
8;Barcelona;1;Barcelona;13;Barcelonès;08015;Badalona;3;14;;997;360;530;701;296;3;1;697;698
8;Barcelona;1;Barcelona;13;Barcelonès;08015;Badalona;3;3;;1354;532;752;962;392;2;3;957;960
8;Barcelona;1;Barcelona;13;Barcelonès;08015;Badalona;3;4;;1333;503;686;948;385;6;0;942;942
8;Barcelona;1;Barcelona;13;Barcelonès;08015;Badalona;3;5;;1073;374;543;673;400;1;3;669;672
8;Barcelona;1;Barcelona;13;Barcelonès;08015;Badalona;3;6;;960;388;563;725;235;3;4;718;722
8;Barcelona;1;Barcelona;13;Barcelonès;08015;Badalona;3;7;;1028;422;610;761;267;1;6;754;760
8;Barcelona;1;Barcelona;13;Barcelonès;08015;Badalona;3;8;;537;197;293;374;163;2;3;369;372
8;Barcelona;1;Barcelona;13;Barcelonès;08015;Badalona;3;9;;1440;549;822;1064;376;2;4;1058;1062
8;Barcelona;1;Barcelona;13;Barcelonès;08015;Badalona;4;1;;1526;457;741;928;598;0;2;926;928
8;Barcelona;1;Barcelona;13;Barcelonès;08015;Badalona;4;10;;940;318;446;537;403;1;0;536;536
8;Barcelona;1;Barcelona;13;Barcelonès;08015;Badalona;4;11;;1121;407;560;713;408;0;4;709;713
8;Barcelona;1;Barcelona;13;Barcelonès;08015;Badalona;4;12;;1080;357;515;642;438;1;4;637;641
8;Barcelona;1;Barcelona;13;Barcelonès;08015;Badalona;4;13;;912;341;469;617;295;4;6;607;613
8;Barcelona;1;Barcelona;13;Barcelonès;08015;Badalona;4;14;;1959;689;1068;1417;542;4;8;1405;1413
8;Barcelona;1;Barcelona;13;Barcelonès;08015;Badalona;4;15;;1054;419;543;720;334;0;9;711;720
8;Barcelona;1;Barcelona;13;Barcelonès;08015;Badalona;4;16;;1485;536;798;1055;430;1;13;1041;1054
8;Barcelona;1;Barcelona;13;Barcelonès;08015;Badalona;4;2;;1223;460;663;824;399;1;5;818;823
8;Barcelona;1;Barcelona;13;Barcelonès;08015;Badalona;4;3;;1180;448;633;809;371;3;6;800;806
8;Barcelona;1;Barcelona;13;Barcelonès;08015;Badalona;4;4;;1820;670;1069;1242;578;7;8;1227;1235
8;Barcelona;1;Barcelona;13;Barcelonès;08015;Badalona;4;5;;1481;513;766;991;490;2;5;984;989
8;Barcelona;1;Barcelona;13;Barcelonès;08015;Badalona;4;6;;1898;604;917;1178;720;4;5;1169;1174
8;Barcelona;1;Barcelona;13;Barcelonès;08015;Badalona;4;7;;1133;453;676;842;291;5;5;832;837
8;Barcelona;1;Barcelona;13;Barcelonès;08015;Badalona;4;8;;1146;402;605;742;404;3;8;731;739
8;Barcelona;1;Barcelona;13;Barcelonès;08015;Badalona;4;9;;714;268;480;484;230;0;3;481;484
8;Barcelona;1;Barcelona;13;Barcelonès;08015;Badalona;5;1;;1789;720;986;1301;488;2;3;1296;1299
8;Barcelona;1;Barcelona;13;Barcelonès;08015;Badalona;5;2;;650;307;401;496;154;2;11;483;494
8;Barcelona;1;Barcelona;13;Barcelonès;08015;Badalona;5;3;;2290;926;1336;1678;612;6;9;1663;1672
8;Barcelona;1;Barcelona;13;Barcelonès;08015;Badalona;5;4;;1287;507;747;884;403;0;11;873;884
8;Barcelona;1;Barcelona;13;Barcelonès;08015;Badalona;5;5;;1505;545;798;1011;494;1;3;1007;1010
8;Barcelona;1;Barcelona;13;Barcelonès;08015;Badalona;5;6;;976;398;569;718;258;1;1;716;717
8;Barcelona;1;Barcelona;13;Barcelonès;08015;Badalona;5;7;;811;322;468;610;201;2;8;600;608
8;Barcelona;1;Barcelona;13;Barcelonès;08015;Badalona;6;1;;1055;382;546;709;346;3;6;700;706
8;Barcelona;1;Barcelona;13;Barcelonès;08015;Badalona;6;2;;1339;496;711;913;426;5;5;903;908
8;Barcelona;1;Barcelona;13;Barcelonès;08015;Badalona;6;3;;882;235;427;540;342;3;2;535;537
8;Barcelona;1;Barcelona;13;Barcelonès;08015;Badalona;6;4;;969;272;431;520;449;1;2;517;519
8;Barcelona;1;Barcelona;13;Barcelonès;08015;Badalona;6;5;;1115;341;487;605;510;4;1;600;601
8;Barcelona;1;Barcelona;13;Barcelonès;08015;Badalona;6;6;;819;236;367;454;365;0;5;449;454
8;Barcelona;1;Barcelona;13;Barcelonès;08015;Badalona;7;1;;1247;429;609;758;489;1;2;755;757
8;Barcelona;1;Barcelona;13;Barcelonès;08015;Badalona;7;10;;599;182;256;329;270;2;0;327;327
8;Barcelona;1;Barcelona;13;Barcelonès;08015;Badalona;7;11;;1542;573;765;953;589;1;3;949;952
8;Barcelona;1;Barcelona;13;Barcelonès;08015;Badalona;7;13;;1232;399;532;646;586;4;0;642;642
8;Barcelona;1;Barcelona;13;Barcelonès;08015;Badalona;7;14;;1203;373;622;688;515;5;3;680;683
8;Barcelona;1;Barcelona;13;Barcelonès;08015;Badalona;7;15;;562;155;229;280;282;2;0;278;278
8;Barcelona;1;Barcelona;13;Barcelonès;08015;Badalona;7;17;;1730;475;697;851;879;4;0;847;847
8;Barcelona;1;Barcelona;13;Barcelonès;08015;Badalona;7;18;;1255;512;738;916;339;2;9;905;914
8;Barcelona;1;Barcelona;13;Barcelonès;08015;Badalona;7;2;;1810;655;975;1210;600;1;4;1205;1209
8;Barcelona;1;Barcelona;13;Barcelonès;08015;Badalona;7;20;;1065;408;573;674;391;4;8;662;670
8;Barcelona;1;Barcelona;13;Barcelonès;08015;Badalona;7;21;;657;228;323;407;250;2;3;402;405
8;Barcelona;1;Barcelona;13;Barcelonès;08015;Badalona;7;22;;597;219;323;403;194;1;2;400;402
8;Barcelona;1;Barcelona;13;Barcelonès;08015;Badalona;7;23;;1593;634;904;1130;463;1;8;1121;1129
8;Barcelona;1;Barcelona;13;Barcelonès;08015;Badalona;7;24;;1316;492;686;892;424;3;4;885;889
8;Barcelona;1;Barcelona;13;Barcelonès;08015;Badalona;7;28;;1315;456;640;793;522;1;6;786;792
8;Barcelona;1;Barcelona;13;Barcelonès;08015;Badalona;7;29;;1655;707;952;1178;477;4;8;1166;1174
8;Barcelona;1;Barcelona;13;Barcelonès;08015;Badalona;7;3;;1100;354;522;611;489;1;2;608;610
8;Barcelona;1;Barcelona;13;Barcelonès;08015;Badalona;7;30;;1602;594;884;1151;451;6;3;1142;1145
8;Barcelona;1;Barcelona;13;Barcelonès;08015;Badalona;7;31;;1031;367;528;689;342;4;3;682;685
8;Barcelona;1;Barcelona;13;Barcelonès;08015;Badalona;7;4;;904;339;489;609;295;1;4;604;608
8;Barcelona;1;Barcelona;13;Barcelonès;08015;Badalona;7;5;;583;192;271;360;223;2;0;358;358
8;Barcelona;1;Barcelona;13;Barcelonès;08015;Badalona;7;6;;818;274;445;554;264;0;5;549;554
8;Barcelona;1;Barcelona;13;Barcelonès;08015;Badalona;7;7;;618;190;265;315;303;0;1;314;315
8;Barcelona;1;Barcelona;13;Barcelonès;08015;Badalona;7;8;;787;254;366;432;355;0;2;430;432
8;Barcelona;1;Barcelona;13;Barcelonès;08015;Badalona;7;9;;1209;465;640;789;420;0;6;783;789
8;Barcelona;1;Barcelona;13;Barcelonès;08015;Badalona;8;1;;1528;459;708;794;734;2;4;788;792
8;Barcelona;1;Barcelona;13;Barcelonès;08015;Badalona;8;11;;668;266;374;462;206;0;1;461;462
8;Barcelona;1;Barcelona;13;Barcelonès;08015;Badalona;8;12;;2042;791;1154;1510;532;1;7;1502;1509
8;Barcelona;1;Barcelona;13;Barcelonès;08015;Badalona;8;13;;790;295;428;556;234;2;3;551;554
8;Barcelona;1;Barcelona;13;Barcelonès;08015;Badalona;8;2;;1852;642;926;1195;657;2;4;1189;1193
8;Barcelona;1;Barcelona;13;Barcelonès;08015;Badalona;8;3;;1496;497;705;928;568;5;1;922;923
8;Barcelona;1;Barcelona;13;Barcelonès;08015;Badalona;8;4;;570;195;288;362;208;1;2;359;361
8;Barcelona;1;Barcelona;13;Barcelonès;08015;Badalona;8;5;;706;248;329;379;327;2;0;377;377
8;Barcelona;1;Barcelona;13;Barcelonès;08015;Badalona;8;6;;1330;514;704;909;421;4;2;903;905
8;Barcelona;1;Barcelona;13;Barcelonès;08015;Badalona;8;7;;930;261;400;512;418;4;2;506;508
8;Barcelona;1;Barcelona;13;Barcelonès;08015;Badalona;8;8;;1449;504;733;931;518;0;3;928;931
8;Barcelona;1;Barcelona;13;Barcelonès;08015;Badalona;8;9;;1000;394;502;650;350;0;4;646;650
8;Barcelona;1;Barcelona;13;Barcelonès;08015;Badalona;9;1;;1124;345;490;580;544;6;3;571;574
8;Barcelona;1;Barcelona;13;Barcelonès;08015;Badalona;9;10;;961;310;403;478;483;1;2;475;477
8;Barcelona;1;Barcelona;13;Barcelonès;08015;Badalona;9;11;;661;232;338;400;261;1;1;398;399
8;Barcelona;1;Barcelona;13;Barcelonès;08015;Badalona;9;12;;1019;373;489;598;421;0;2;596;598
8;Barcelona;1;Barcelona;13;Barcelonès;08015;Badalona;9;13;;573;219;291;373;200;0;0;373;373
8;Barcelona;1;Barcelona;13;Barcelonès;08015;Badalona;9;14;;1135;419;580;768;367;3;3;762;765
8;Barcelona;1;Barcelona;13;Barcelonès;08015;Badalona;9;15;;1121;350;453;596;525;3;2;591;593
8;Barcelona;1;Barcelona;13;Barcelonès;08015;Badalona;9;16;;1214;442;580;747;467;2;1;744;745
8;Barcelona;1;Barcelona;13;Barcelonès;08015;Badalona;9;17;;885;233;348;427;458;0;1;426;427
8;Barcelona;1;Barcelona;13;Barcelonès;08015;Badalona;9;18;;1290;463;583;723;567;3;3;717;720
8;Barcelona;1;Barcelona;13;Barcelonès;08015;Badalona;9;19;;778;254;343;414;364;1;3;410;413
8;Barcelona;1;Barcelona;13;Barcelonès;08015;Badalona;9;2;;970;222;348;418;552;0;2;416;418
8;Barcelona;1;Barcelona;13;Barcelonès;08015;Badalona;9;20;;503;187;270;334;169;2;1;331;332
8;Barcelona;1;Barcelona;13;Barcelonès;08015;Badalona;9;21;;1030;381;503;624;406;2;3;619;622
8;Barcelona;1;Barcelona;13;Barcelonès;08015;Badalona;9;22;;971;331;480;600;371;3;3;594;597
8;Barcelona;1;Barcelona;13;Barcelonès;08015;Badalona;9;23;;1106;406;561;684;422;3;2;679;681
8;Barcelona;1;Barcelona;13;Barcelonès;08015;Badalona;9;24;;1406;582;810;979;427;1;2;976;978
8;Barcelona;1;Barcelona;13;Barcelonès;08015;Badalona;9;25;;837;288;392;477;360;0;10;467;477
8;Barcelona;1;Barcelona;13;Barcelonès;08015;Badalona;9;26;;925;345;496;609;316;0;4;605;609
8;Barcelona;1;Barcelona;13;Barcelonès;08015;Badalona;9;27;;635;210;311;376;259;1;1;374;375
8;Barcelona;1;Barcelona;13;Barcelonès;08015;Badalona;9;28;;1541;441;603;775;766;2;3;770;773
8;Barcelona;1;Barcelona;13;Barcelonès;08015;Badalona;9;3;;631;180;300;357;274;2;3;352;355
8;Barcelona;1;Barcelona;13;Barcelonès;08015;Badalona;9;30;;1095;266;428;559;536;3;2;554;556
8;Barcelona;1;Barcelona;13;Barcelonès;08015;Badalona;9;31;;753;296;417;513;240;4;2;507;509
8;Barcelona;1;Barcelona;13;Barcelonès;08015;Badalona;9;32;;597;186;268;314;283;0;0;314;314
8;Barcelona;1;Barcelona;13;Barcelonès;08015;Badalona;9;33;;1175;465;624;757;418;2;2;753;755
8;Barcelona;1;Barcelona;13;Barcelonès;08015;Badalona;9;34;;1374;515;713;921;453;0;9;912;921
8;Barcelona;1;Barcelona;13;Barcelonès;08015;Badalona;9;35;;1059;381;508;677;382;2;5;670;675
8;Barcelona;1;Barcelona;13;Barcelonès;08015;Badalona;9;36;;927;278;433;544;383;4;2;538;540
8;Barcelona;1;Barcelona;13;Barcelonès;08015;Badalona;9;37;;626;134;202;264;362;1;0;263;263
8;Barcelona;1;Barcelona;13;Barcelonès;08015;Badalona;9;38;;818;183;267;349;469;2;1;346;347
8;Barcelona;1;Barcelona;13;Barcelonès;08015;Badalona;9;4;;931;146;226;282;649;0;3;279;282
8;Barcelona;1;Barcelona;13;Barcelonès;08015;Badalona;9;42;;708;98;150;180;528;1;1;178;179
8;Barcelona;1;Barcelona;13;Barcelonès;08015;Badalona;9;43;;1331;535;711;920;411;0;2;918;920
8;Barcelona;1;Barcelona;13;Barcelonès;08015;Badalona;9;44;;668;241;349;428;240;0;2;426;428
8;Barcelona;1;Barcelona;13;Barcelonès;08015;Badalona;9;45;;1213;461;651;803;410;3;3;797;800
8;Barcelona;1;Barcelona;13;Barcelonès;08015;Badalona;9;47;;716;245;325;409;307;0;0;409;409
8;Barcelona;1;Barcelona;13;Barcelonès;08015;Badalona;9;49;;981;361;468;568;413;2;0;566;566
8;Barcelona;1;Barcelona;13;Barcelonès;08015;Badalona;9;5;;741;234;303;367;374;1;3;363;366
8;Barcelona;1;Barcelona;13;Barcelonès;08015;Badalona;9;52;;660;252;362;430;230;0;3;427;430
8;Barcelona;1;Barcelona;13;Barcelonès;08015;Badalona;9;53;;788;225;352;436;352;2;0;434;434
8;Barcelona;1;Barcelona;13;Barcelonès;08015;Badalona;9;54;;908;264;436;583;325;1;4;578;582
8;Barcelona;1;Barcelona;13;Barcelonès;08015;Badalona;9;57;;927;289;414;528;399;0;1;527;528
8;Barcelona;1;Barcelona;13;Barcelonès;08015;Badalona;9;58;;1085;428;569;717;368;2;6;709;715
8;Barcelona;1;Barcelona;13;Barcelonès;08015;Badalona;9;59;;863;240;399;524;339;1;2;521;523
8;Barcelona;1;Barcelona;13;Barcelonès;08015;Badalona;9;6;;829;196;303;362;467;0;0;362;362
8;Barcelona;1;Barcelona;13;Barcelonès;08015;Badalona;9;8;;1024;354;434;525;499;4;1;520;521
8;Barcelona;1;Barcelona;13;Barcelonès;08015;Badalona;9;9;;789;287;419;531;258;2;3;526;529
8;Barcelona;1;Barcelona;40;Vallès Occidental;08904;Badia del Vallès;1;1;;861;335;422;524;337;1;3;520;523
8;Barcelona;1;Barcelona;40;Vallès Occidental;08904;Badia del Vallès;1;10;;728;277;362;452;276;3;5;444;449
8;Barcelona;1;Barcelona;40;Vallès Occidental;08904;Badia del Vallès;1;11;;942;286;409;525;417;1;0;524;524
8;Barcelona;1;Barcelona;40;Vallès Occidental;08904;Badia del Vallès;1;12;;920;325;424;536;384;1;3;532;535
8;Barcelona;1;Barcelona;40;Vallès Occidental;08904;Badia del Vallès;1;2;;652;140;257;329;323;2;3;324;327
8;Barcelona;1;Barcelona;40;Vallès Occidental;08904;Badia del Vallès;1;3;;932;300;419;508;424;2;2;504;506
8;Barcelona;1;Barcelona;40;Vallès Occidental;08904;Badia del Vallès;1;4;;906;220;334;439;467;0;2;437;439
8;Barcelona;1;Barcelona;40;Vallès Occidental;08904;Badia del Vallès;1;5;;908;259;363;452;456;4;3;445;448
8;Barcelona;1;Barcelona;40;Vallès Occidental;08904;Badia del Vallès;1;6;;1131;359;514;600;531;0;5;595;600
8;Barcelona;1;Barcelona;40;Vallès Occidental;08904;Badia del Vallès;1;7;;845;282;364;460;385;1;3;456;459
8;Barcelona;1;Barcelona;40;Vallès Occidental;08904;Badia del Vallès;1;8;;859;251;351;454;405;4;3;447;450
8;Barcelona;1;Barcelona;40;Vallès Occidental;08904;Badia del Vallès;1;9;;855;277;368;439;416;1;4;434;438
8;Barcelona;2;Catalunya Central;14;Berguedà;08016;Bagà;1;1;;1813;726;1122;1335;478;21;33;1281;1314
25;Lleida;5;Alt Pirineu i territori d'Aran;26;Pallars Sobirà;25039;Baix Pallars;1;1;;268;95;148;227;41;2;11;214;225
25;Lleida;4;Lleida;23;Noguera;25040;Balaguer;1;1;;731;292;373;464;267;8;5;451;456
25;Lleida;4;Lleida;23;Noguera;25040;Balaguer;1;2;;926;318;446;569;357;1;6;562;568
25;Lleida;4;Lleida;23;Noguera;25040;Balaguer;2;1;;896;310;455;574;322;1;3;570;573
25;Lleida;4;Lleida;23;Noguera;25040;Balaguer;3;1;;2107;659;985;1294;813;9;19;1266;1285
25;Lleida;4;Lleida;23;Noguera;25040;Balaguer;3;2;;848;284;420;538;310;4;6;528;534
25;Lleida;4;Lleida;23;Noguera;25040;Balaguer;4;1;;1221;502;683;859;362;5;19;835;854
25;Lleida;4;Lleida;23;Noguera;25040;Balaguer;4;2;;1164;422;583;765;399;2;14;749;763
25;Lleida;4;Lleida;23;Noguera;25040;Balaguer;4;3;;1220;470;708;874;346;13;8;853;861
25;Lleida;4;Lleida;23;Noguera;25040;Balaguer;4;4;;1732;677;948;1233;499;9;10;1214;1224
8;Barcelona;2;Catalunya Central;24;Osona;08017;Balenyà;1;1;;2001;702;1095;1330;671;12;39;1279;1318
8;Barcelona;2;Catalunya Central;24;Osona;08017;Balenyà;1;2;;818;295;409;525;293;6;16;503;519
8;Barcelona;2;Catalunya Central;7;Bages;08018;Balsareny;1;1;;1248;438;650;861;387;31;46;784;830
8;Barcelona;2;Catalunya Central;7;Bages;08018;Balsareny;1;2;;972;364;519;642;330;27;44;571;615
8;Barcelona;2;Catalunya Central;7;Bages;08018;Balsareny;1;3;;329;109;176;224;105;5;3;216;219
43;Tarragona;8;Penedès;12;Baix Penedès;43020;Banyeres del Penedès;1;1;;1365;520;763;959;406;3;9;947;956
43;Tarragona;8;Penedès;12;Baix Penedès;43020;Banyeres del Penedès;1;2;;939;348;464;607;332;5;7;595;602
17;Girona;3;Girona;28;Pla de l'Estany;17015;Banyoles;1;1;;1143;468;644;785;358;6;11;768;779
17;Girona;3;Girona;28;Pla de l'Estany;17015;Banyoles;1;2;;739;313;444;552;187;6;5;541;546
17;Girona;3;Girona;28;Pla de l'Estany;17015;Banyoles;1;3;;1002;402;524;702;300;6;13;683;696
17;Girona;3;Girona;28;Pla de l'Estany;17015;Banyoles;1;4;;1372;564;776;958;414;12;25;921;946
17;Girona;3;Girona;28;Pla de l'Estany;17015;Banyoles;1;5;;1044;450;623;747;297;4;10;733;743
17;Girona;3;Girona;28;Pla de l'Estany;17015;Banyoles;2;1;;1297;541;763;960;337;9;19;932;951
17;Girona;3;Girona;28;Pla de l'Estany;17015;Banyoles;2;2;;991;418;609;742;249;2;18;722;740
17;Girona;3;Girona;28;Pla de l'Estany;17015;Banyoles;2;3;;1405;555;805;1022;383;9;18;995;1013
17;Girona;3;Girona;28;Pla de l'Estany;17015;Banyoles;2;4;;540;235;310;380;160;3;8;369;377
17;Girona;3;Girona;28;Pla de l'Estany;17015;Banyoles;2;5;;957;383;561;758;199;2;11;745;756
17;Girona;3;Girona;28;Pla de l'Estany;17015;Banyoles;3;1;;1384;552;800;1040;344;5;22;1013;1035
17;Girona;3;Girona;28;Pla de l'Estany;17015;Banyoles;3;2;;1105;354;510;674;431;8;19;647;666
25;Lleida;4;Lleida;27;Pla d'Urgell;25041;Barbens;1;1;;532;275;384;457;75;11;9;437;446
43;Tarragona;6;Camp de Tarragona;16;Conca de Barberà;43021;Barberà de la Conca;1;1;;347;145;172;216;131;16;28;172;200
8;Barcelona;1;Barcelona;40;Vallès Occidental;08252;Barberà del Vallès;1;1;;1976;695;988;1295;681;4;17;1274;1291
8;Barcelona;1;Barcelona;40;Vallès Occidental;08252;Barberà del Vallès;1;10;;1107;363;540;716;391;1;7;708;715
8;Barcelona;1;Barcelona;40;Vallès Occidental;08252;Barberà del Vallès;1;11;;1328;492;650;849;479;6;5;838;843
8;Barcelona;1;Barcelona;40;Vallès Occidental;08252;Barberà del Vallès;1;18;;785;294;383;482;303;3;1;478;479
8;Barcelona;1;Barcelona;40;Vallès Occidental;08252;Barberà del Vallès;1;19;;1094;400;516;650;444;7;3;640;643
8;Barcelona;1;Barcelona;40;Vallès Occidental;08252;Barberà del Vallès;1;2;;962;332;474;589;373;1;4;584;588
8;Barcelona;1;Barcelona;40;Vallès Occidental;08252;Barberà del Vallès;1;20;;774;250;344;425;349;0;1;424;425
8;Barcelona;1;Barcelona;40;Vallès Occidental;08252;Barberà del Vallès;1;21;;1030;341;472;630;400;2;4;624;628
8;Barcelona;1;Barcelona;40;Vallès Occidental;08252;Barberà del Vallès;1;22;;1699;588;859;1135;564;0;8;1127;1135
8;Barcelona;1;Barcelona;40;Vallès Occidental;08252;Barberà del Vallès;1;23;;640;233;323;413;227;4;1;408;409
8;Barcelona;1;Barcelona;40;Vallès Occidental;08252;Barberà del Vallès;1;24;;731;234;349;426;305;0;2;424;426
8;Barcelona;1;Barcelona;40;Vallès Occidental;08252;Barberà del Vallès;1;25;;839;277;410;519;320;1;1;517;518
8;Barcelona;1;Barcelona;40;Vallès Occidental;08252;Barberà del Vallès;1;26;;1788;521;813;1072;716;1;5;1066;1071
8;Barcelona;1;Barcelona;40;Vallès Occidental;08252;Barberà del Vallès;1;27;;1660;513;752;1011;649;1;7;1003;1010
8;Barcelona;1;Barcelona;40;Vallès Occidental;08252;Barberà del Vallès;1;28;;1191;414;568;759;432;5;4;750;754
8;Barcelona;1;Barcelona;40;Vallès Occidental;08252;Barberà del Vallès;1;29;;1088;323;507;690;398;0;3;687;690
8;Barcelona;1;Barcelona;40;Vallès Occidental;08252;Barberà del Vallès;1;3;;1031;361;472;613;418;3;2;608;610
8;Barcelona;1;Barcelona;40;Vallès Occidental;08252;Barberà del Vallès;1;4;;1072;355;510;627;445;0;1;626;627
8;Barcelona;1;Barcelona;40;Vallès Occidental;08252;Barberà del Vallès;1;5;;1069;328;479;601;468;1;0;600;600
8;Barcelona;1;Barcelona;40;Vallès Occidental;08252;Barberà del Vallès;1;6;;790;313;430;515;275;1;4;510;514
8;Barcelona;1;Barcelona;40;Vallès Occidental;08252;Barberà del Vallès;1;7;;693;278;371;470;223;2;3;465;468
8;Barcelona;1;Barcelona;40;Vallès Occidental;08252;Barberà del Vallès;1;8;;952;300;443;560;392;4;7;549;556
8;Barcelona;1;Barcelona;40;Vallès Occidental;08252;Barberà del Vallès;1;9;;626;226;306;398;228;2;2;394;396
8;Barcelona;1;Barcelona;13;Barcelonès;08019;Barcelona;1;1;;637;202;279;356;281;1;0;355;355
8;Barcelona;1;Barcelona;13;Barcelonès;08019;Barcelona;1;10;;876;224;311;388;488;1;1;386;387
8;Barcelona;1;Barcelona;13;Barcelonès;08019;Barcelona;1;11;;1116;250;381;464;652;0;2;462;464
8;Barcelona;1;Barcelona;13;Barcelonès;08019;Barcelona;1;12;;907;264;393;469;438;0;0;469;469
8;Barcelona;1;Barcelona;13;Barcelonès;08019;Barcelona;1;13;;750;234;316;387;363;1;1;385;386
8;Barcelona;1;Barcelona;13;Barcelonès;08019;Barcelona;1;14;;938;208;321;392;546;1;2;389;391
8;Barcelona;1;Barcelona;13;Barcelonès;08019;Barcelona;1;15;;960;242;361;450;510;0;2;448;450
8;Barcelona;1;Barcelona;13;Barcelonès;08019;Barcelona;1;16;;869;196;285;378;491;0;3;375;378
8;Barcelona;1;Barcelona;13;Barcelonès;08019;Barcelona;1;17;;1024;248;389;453;571;1;4;448;452
8;Barcelona;1;Barcelona;13;Barcelonès;08019;Barcelona;1;18;;763;226;320;371;392;0;2;369;371
8;Barcelona;1;Barcelona;13;Barcelonès;08019;Barcelona;1;19;;1178;278;416;531;647;1;4;526;530
8;Barcelona;1;Barcelona;13;Barcelonès;08019;Barcelona;1;2;;575;163;228;281;294;0;2;279;281
8;Barcelona;1;Barcelona;13;Barcelonès;08019;Barcelona;1;20;;1216;431;624;782;434;1;4;777;781
8;Barcelona;1;Barcelona;13;Barcelonès;08019;Barcelona;1;21;;1117;353;519;666;451;1;0;665;665
8;Barcelona;1;Barcelona;13;Barcelonès;08019;Barcelona;1;22;;728;250;367;489;239;1;1;487;488
8;Barcelona;1;Barcelona;13;Barcelonès;08019;Barcelona;1;23;;1138;413;554;678;460;0;1;677;678
8;Barcelona;1;Barcelona;13;Barcelonès;08019;Barcelona;1;25;;624;212;303;391;233;0;0;391;391
8;Barcelona;1;Barcelona;13;Barcelonès;08019;Barcelona;1;26;;1302;283;403;522;780;2;4;516;520
8;Barcelona;1;Barcelona;13;Barcelonès;08019;Barcelona;1;27;;820;270;371;472;348;1;4;467;471
8;Barcelona;1;Barcelona;13;Barcelonès;08019;Barcelona;1;28;;869;267;408;499;370;0;2;497;499
8;Barcelona;1;Barcelona;13;Barcelonès;08019;Barcelona;1;29;;588;151;228;295;293;1;0;294;294
8;Barcelona;1;Barcelona;13;Barcelonès;08019;Barcelona;1;3;;1364;346;467;626;738;1;1;624;625
8;Barcelona;1;Barcelona;13;Barcelonès;08019;Barcelona;1;30;;1208;379;518;660;548;3;0;657;657
8;Barcelona;1;Barcelona;13;Barcelonès;08019;Barcelona;1;31;;684;153;256;342;342;0;1;341;342
8;Barcelona;1;Barcelona;13;Barcelonès;08019;Barcelona;1;32;;1044;324;486;594;450;2;2;590;592
8;Barcelona;1;Barcelona;13;Barcelonès;08019;Barcelona;1;33;;620;190;247;313;307;2;1;310;311
8;Barcelona;1;Barcelona;13;Barcelonès;08019;Barcelona;1;34;;524;138;194;251;273;0;1;250;251
8;Barcelona;1;Barcelona;13;Barcelonès;08019;Barcelona;1;35;;706;202;286;353;353;0;0;353;353
8;Barcelona;1;Barcelona;13;Barcelonès;08019;Barcelona;1;36;;815;253;348;426;389;0;1;425;426
8;Barcelona;1;Barcelona;13;Barcelonès;08019;Barcelona;1;37;;908;318;414;506;402;1;1;504;505
8;Barcelona;1;Barcelona;13;Barcelonès;08019;Barcelona;1;38;;705;204;313;380;325;0;0;380;380
8;Barcelona;1;Barcelona;13;Barcelonès;08019;Barcelona;1;39;;785;275;385;487;298;2;3;482;485
8;Barcelona;1;Barcelona;13;Barcelonès;08019;Barcelona;1;4;;1376;382;580;756;620;0;2;754;756
8;Barcelona;1;Barcelona;13;Barcelonès;08019;Barcelona;1;40;;564;196;271;319;245;5;0;314;314
8;Barcelona;1;Barcelona;13;Barcelonès;08019;Barcelona;1;41;;695;203;229;349;346;1;0;348;348
8;Barcelona;1;Barcelona;13;Barcelonès;08019;Barcelona;1;42;;1242;435;595;702;540;1;1;700;701
8;Barcelona;1;Barcelona;13;Barcelonès;08019;Barcelona;1;43;;908;271;422;577;331;1;3;573;576
8;Barcelona;1;Barcelona;13;Barcelonès;08019;Barcelona;1;44;;806;249;384;500;306;1;1;498;499
8;Barcelona;1;Barcelona;13;Barcelonès;08019;Barcelona;1;45;;988;270;416;533;455;1;3;529;532
8;Barcelona;1;Barcelona;13;Barcelonès;08019;Barcelona;1;46;;874;261;361;445;429;1;0;444;444
8;Barcelona;1;Barcelona;13;Barcelonès;08019;Barcelona;1;47;;913;267;384;508;405;2;3;503;506
8;Barcelona;1;Barcelona;13;Barcelonès;08019;Barcelona;1;48;;1071;237;359;511;560;1;3;507;510
8;Barcelona;1;Barcelona;13;Barcelonès;08019;Barcelona;1;49;;774;258;367;451;323;2;0;449;449
8;Barcelona;1;Barcelona;13;Barcelonès;08019;Barcelona;1;5;;1074;276;390;479;595;1;2;476;478
8;Barcelona;1;Barcelona;13;Barcelonès;08019;Barcelona;1;50;;810;241;360;458;352;1;2;455;457
8;Barcelona;1;Barcelona;13;Barcelonès;08019;Barcelona;1;51;;849;323;344;443;406;1;1;441;442
8;Barcelona;1;Barcelona;13;Barcelonès;08019;Barcelona;1;52;;1333;479;711;897;436;1;4;892;896
8;Barcelona;1;Barcelona;13;Barcelonès;08019;Barcelona;1;53;;1104;248;488;596;508;2;0;594;594
8;Barcelona;1;Barcelona;13;Barcelonès;08019;Barcelona;1;54;;710;230;354;425;285;1;0;424;424
8;Barcelona;1;Barcelona;13;Barcelonès;08019;Barcelona;1;55;;901;401;542;601;300;0;3;598;601
8;Barcelona;1;Barcelona;13;Barcelonès;08019;Barcelona;1;6;;641;176;260;311;330;0;0;311;311
8;Barcelona;1;Barcelona;13;Barcelonès;08019;Barcelona;1;7;;794;212;301;373;421;0;2;371;373
8;Barcelona;1;Barcelona;13;Barcelonès;08019;Barcelona;1;8;;1192;278;424;513;679;4;3;506;509
8;Barcelona;1;Barcelona;13;Barcelonès;08019;Barcelona;1;9;;947;262;374;463;484;0;3;460;463
8;Barcelona;1;Barcelona;13;Barcelonès;08019;Barcelona;10;1;;1092;394;550;696;396;1;4;691;695
8;Barcelona;1;Barcelona;13;Barcelonès;08019;Barcelona;10;10;;1214;450;646;801;413;2;3;796;799
8;Barcelona;1;Barcelona;13;Barcelonès;08019;Barcelona;10;100;;1139;394;591;762;377;2;0;760;760
8;Barcelona;1;Barcelona;13;Barcelonès;08019;Barcelona;10;101;;974;316;463;609;365;5;4;600;604
8;Barcelona;1;Barcelona;13;Barcelonès;08019;Barcelona;10;102;;1866;679;949;1210;656;4;1;1205;1206
8;Barcelona;1;Barcelona;13;Barcelonès;08019;Barcelona;10;103;;1757;671;1006;1237;520;2;5;1230;1235
8;Barcelona;1;Barcelona;13;Barcelonès;08019;Barcelona;10;104;;1372;563;805;1024;348;4;4;1016;1020
8;Barcelona;1;Barcelona;13;Barcelonès;08019;Barcelona;10;105;;1752;658;930;1208;544;4;6;1198;1204
8;Barcelona;1;Barcelona;13;Barcelonès;08019;Barcelona;10;106;;776;312;434;560;216;1;0;559;559
8;Barcelona;1;Barcelona;13;Barcelonès;08019;Barcelona;10;107;;1206;473;679;853;353;1;2;850;852
8;Barcelona;1;Barcelona;13;Barcelonès;08019;Barcelona;10;108;;1072;378;525;662;410;2;1;659;660
8;Barcelona;1;Barcelona;13;Barcelonès;08019;Barcelona;10;109;;1174;442;618;750;424;0;1;749;750
8;Barcelona;1;Barcelona;13;Barcelonès;08019;Barcelona;10;11;;894;364;511;619;275;0;0;619;619
8;Barcelona;1;Barcelona;13;Barcelonès;08019;Barcelona;10;110;;1192;437;582;768;424;0;3;765;768
8;Barcelona;1;Barcelona;13;Barcelonès;08019;Barcelona;10;111;;961;351;528;657;304;2;2;653;655
8;Barcelona;1;Barcelona;13;Barcelonès;08019;Barcelona;10;112;;1231;500;741;951;280;0;1;950;951
8;Barcelona;1;Barcelona;13;Barcelonès;08019;Barcelona;10;113;;838;283;446;550;288;1;4;545;549
8;Barcelona;1;Barcelona;13;Barcelonès;08019;Barcelona;10;114;;981;313;456;598;383;1;3;594;597
8;Barcelona;1;Barcelona;13;Barcelonès;08019;Barcelona;10;115;;1011;306;477;605;406;2;2;601;603
8;Barcelona;1;Barcelona;13;Barcelonès;08019;Barcelona;10;116;;1319;435;762;802;517;4;4;794;798
8;Barcelona;1;Barcelona;13;Barcelonès;08019;Barcelona;10;117;;967;342;488;620;347;0;3;617;620
8;Barcelona;1;Barcelona;13;Barcelonès;08019;Barcelona;10;118;;805;342;485;597;208;2;1;594;595
8;Barcelona;1;Barcelona;13;Barcelonès;08019;Barcelona;10;119;;876;283;420;501;375;3;1;497;498
8;Barcelona;1;Barcelona;13;Barcelonès;08019;Barcelona;10;12;;1295;504;716;942;353;0;1;941;942
8;Barcelona;1;Barcelona;13;Barcelonès;08019;Barcelona;10;120;;1051;375;550;654;397;7;1;646;647
8;Barcelona;1;Barcelona;13;Barcelonès;08019;Barcelona;10;121;;1139;376;560;706;433;0;1;705;706
8;Barcelona;1;Barcelona;13;Barcelonès;08019;Barcelona;10;122;;1225;534;727;923;302;2;2;919;921
8;Barcelona;1;Barcelona;13;Barcelonès;08019;Barcelona;10;123;;1049;410;572;701;348;2;3;696;699
8;Barcelona;1;Barcelona;13;Barcelonès;08019;Barcelona;10;124;;868;315;444;577;291;2;0;575;575
8;Barcelona;1;Barcelona;13;Barcelonès;08019;Barcelona;10;125;;862;335;454;562;300;1;1;560;561
8;Barcelona;1;Barcelona;13;Barcelonès;08019;Barcelona;10;126;;825;321;467;558;267;1;1;556;557
8;Barcelona;1;Barcelona;13;Barcelonès;08019;Barcelona;10;127;;757;275;374;498;259;1;3;494;497
8;Barcelona;1;Barcelona;13;Barcelonès;08019;Barcelona;10;128;;1286;499;708;896;390;4;5;887;892
8;Barcelona;1;Barcelona;13;Barcelonès;08019;Barcelona;10;129;;975;356;550;731;244;1;7;723;730
8;Barcelona;1;Barcelona;13;Barcelonès;08019;Barcelona;10;13;;1029;414;576;714;315;2;2;710;712
8;Barcelona;1;Barcelona;13;Barcelonès;08019;Barcelona;10;130;;910;309;458;578;332;1;4;573;577
8;Barcelona;1;Barcelona;13;Barcelonès;08019;Barcelona;10;131;;976;328;490;662;314;1;2;659;661
8;Barcelona;1;Barcelona;13;Barcelonès;08019;Barcelona;10;132;;962;383;533;624;338;5;2;617;619
8;Barcelona;1;Barcelona;13;Barcelonès;08019;Barcelona;10;133;;1250;484;661;833;417;3;1;829;830
8;Barcelona;1;Barcelona;13;Barcelonès;08019;Barcelona;10;134;;1158;564;758;776;382;4;1;771;772
8;Barcelona;1;Barcelona;13;Barcelonès;08019;Barcelona;10;135;;928;311;433;569;359;1;3;565;568
8;Barcelona;1;Barcelona;13;Barcelonès;08019;Barcelona;10;136;;1044;397;542;673;371;3;7;663;670
8;Barcelona;1;Barcelona;13;Barcelonès;08019;Barcelona;10;137;;1144;396;539;659;485;3;0;656;656
8;Barcelona;1;Barcelona;13;Barcelonès;08019;Barcelona;10;138;;1104;288;417;494;610;3;2;489;491
8;Barcelona;1;Barcelona;13;Barcelonès;08019;Barcelona;10;139;;1167;356;543;661;506;0;1;660;661
8;Barcelona;1;Barcelona;13;Barcelonès;08019;Barcelona;10;14;;1043;343;543;707;336;1;4;702;706
8;Barcelona;1;Barcelona;13;Barcelonès;08019;Barcelona;10;140;;1105;350;486;615;490;5;1;609;610
8;Barcelona;1;Barcelona;13;Barcelonès;08019;Barcelona;10;141;;857;284;398;485;372;3;0;482;482
8;Barcelona;1;Barcelona;13;Barcelonès;08019;Barcelona;10;142;;1140;369;500;640;500;3;2;635;637
8;Barcelona;1;Barcelona;13;Barcelonès;08019;Barcelona;10;143;;1252;407;587;727;525;2;3;722;725
8;Barcelona;1;Barcelona;13;Barcelonès;08019;Barcelona;10;15;;1322;476;678;900;422;1;4;895;899
8;Barcelona;1;Barcelona;13;Barcelonès;08019;Barcelona;10;16;;928;314;504;655;273;0;0;655;655
8;Barcelona;1;Barcelona;13;Barcelonès;08019;Barcelona;10;17;;1209;476;651;820;389;1;4;815;819
8;Barcelona;1;Barcelona;13;Barcelonès;08019;Barcelona;10;18;;964;382;528;645;319;2;2;641;643
8;Barcelona;1;Barcelona;13;Barcelonès;08019;Barcelona;10;19;;1210;497;704;861;349;2;1;858;859
8;Barcelona;1;Barcelona;13;Barcelonès;08019;Barcelona;10;2;;1294;471;675;850;444;2;3;845;848
8;Barcelona;1;Barcelona;13;Barcelonès;08019;Barcelona;10;20;;1095;433;607;739;356;1;2;736;738
8;Barcelona;1;Barcelona;13;Barcelonès;08019;Barcelona;10;21;;972;372;509;639;333;3;3;633;636
8;Barcelona;1;Barcelona;13;Barcelonès;08019;Barcelona;10;22;;985;365;526;687;298;2;3;682;685
8;Barcelona;1;Barcelona;13;Barcelonès;08019;Barcelona;10;23;;1073;401;577;720;353;0;2;718;720
8;Barcelona;1;Barcelona;13;Barcelonès;08019;Barcelona;10;234;;1448;521;785;979;469;3;5;971;976
8;Barcelona;1;Barcelona;13;Barcelonès;08019;Barcelona;10;235;;1013;317;489;619;394;3;2;614;616
8;Barcelona;1;Barcelona;13;Barcelonès;08019;Barcelona;10;236;;1272;493;672;815;457;2;0;813;813
8;Barcelona;1;Barcelona;13;Barcelonès;08019;Barcelona;10;237;;654;228;330;407;247;2;0;405;405
8;Barcelona;1;Barcelona;13;Barcelonès;08019;Barcelona;10;24;;1042;377;557;719;323;0;0;719;719
8;Barcelona;1;Barcelona;13;Barcelonès;08019;Barcelona;10;25;;967;318;487;611;356;3;3;605;608
8;Barcelona;1;Barcelona;13;Barcelonès;08019;Barcelona;10;26;;1021;358;533;698;323;1;5;692;697
8;Barcelona;1;Barcelona;13;Barcelonès;08019;Barcelona;10;27;;1184;489;671;829;355;2;5;822;827
8;Barcelona;1;Barcelona;13;Barcelonès;08019;Barcelona;10;28;;1317;527;730;931;386;3;4;924;928
8;Barcelona;1;Barcelona;13;Barcelonès;08019;Barcelona;10;29;;1103;375;587;759;344;0;6;753;759
8;Barcelona;1;Barcelona;13;Barcelonès;08019;Barcelona;10;3;;1128;427;621;800;328;3;3;794;797
8;Barcelona;1;Barcelona;13;Barcelonès;08019;Barcelona;10;30;;1367;522;772;959;408;1;3;955;958
8;Barcelona;1;Barcelona;13;Barcelonès;08019;Barcelona;10;31;;1126;355;600;739;387;2;5;732;737
8;Barcelona;1;Barcelona;13;Barcelonès;08019;Barcelona;10;32;;1019;348;559;758;261;1;3;754;757
8;Barcelona;1;Barcelona;13;Barcelonès;08019;Barcelona;10;33;;772;315;458;557;215;0;1;556;557
8;Barcelona;1;Barcelona;13;Barcelonès;08019;Barcelona;10;34;;1320;489;692;888;432;1;5;882;887
8;Barcelona;1;Barcelona;13;Barcelonès;08019;Barcelona;10;35;;1524;513;832;1078;446;1;4;1073;1077
8;Barcelona;1;Barcelona;13;Barcelonès;08019;Barcelona;10;36;;1022;287;596;770;252;5;8;757;765
8;Barcelona;1;Barcelona;13;Barcelonès;08019;Barcelona;10;37;;715;206;338;415;300;2;1;412;413
8;Barcelona;1;Barcelona;13;Barcelonès;08019;Barcelona;10;38;;1175;425;662;837;338;1;4;832;836
8;Barcelona;1;Barcelona;13;Barcelonès;08019;Barcelona;10;39;;1202;430;619;776;426;2;3;771;774
8;Barcelona;1;Barcelona;13;Barcelonès;08019;Barcelona;10;4;;1126;489;667;824;302;2;4;818;822
8;Barcelona;1;Barcelona;13;Barcelonès;08019;Barcelona;10;40;;1265;470;664;807;458;0;10;797;807
8;Barcelona;1;Barcelona;13;Barcelonès;08019;Barcelona;10;41;;1132;365;609;765;367;0;2;763;765
8;Barcelona;1;Barcelona;13;Barcelonès;08019;Barcelona;10;42;;1800;604;876;1132;668;2;2;1128;1130
8;Barcelona;1;Barcelona;13;Barcelonès;08019;Barcelona;10;43;;1187;442;614;752;435;2;0;750;750
8;Barcelona;1;Barcelona;13;Barcelonès;08019;Barcelona;10;44;;1137;389;604;750;387;0;2;748;750
8;Barcelona;1;Barcelona;13;Barcelonès;08019;Barcelona;10;45;;959;370;582;699;260;1;1;697;698
8;Barcelona;1;Barcelona;13;Barcelonès;08019;Barcelona;10;46;;903;262;515;636;267;1;6;629;635
8;Barcelona;1;Barcelona;13;Barcelonès;08019;Barcelona;10;47;;1284;476;757;933;351;4;0;929;929
8;Barcelona;1;Barcelona;13;Barcelonès;08019;Barcelona;10;48;;1135;367;594;776;359;1;2;773;775
8;Barcelona;1;Barcelona;13;Barcelonès;08019;Barcelona;10;49;;960;391;555;675;285;3;3;669;672
8;Barcelona;1;Barcelona;13;Barcelonès;08019;Barcelona;10;5;;1265;471;693;853;412;0;3;850;853
8;Barcelona;1;Barcelona;13;Barcelonès;08019;Barcelona;10;50;;1192;503;710;890;302;5;2;883;885
8;Barcelona;1;Barcelona;13;Barcelonès;08019;Barcelona;10;51;;1092;444;657;816;276;2;6;808;814
8;Barcelona;1;Barcelona;13;Barcelonès;08019;Barcelona;10;52;;1618;608;954;1241;377;3;3;1235;1238
8;Barcelona;1;Barcelona;13;Barcelonès;08019;Barcelona;10;53;;1299;546;782;1038;261;1;3;1034;1037
8;Barcelona;1;Barcelona;13;Barcelonès;08019;Barcelona;10;54;;671;250;390;498;173;3;0;495;495
8;Barcelona;1;Barcelona;13;Barcelonès;08019;Barcelona;10;55;;1844;718;1115;1444;400;1;2;1441;1443
8;Barcelona;1;Barcelona;13;Barcelonès;08019;Barcelona;10;56;;1123;343;479;665;458;2;1;662;663
8;Barcelona;1;Barcelona;13;Barcelonès;08019;Barcelona;10;57;;901;304;424;583;318;0;0;583;583
8;Barcelona;1;Barcelona;13;Barcelonès;08019;Barcelona;10;58;;766;280;400;518;248;2;2;514;516
8;Barcelona;1;Barcelona;13;Barcelonès;08019;Barcelona;10;59;;1061;349;496;652;409;0;1;651;652
8;Barcelona;1;Barcelona;13;Barcelonès;08019;Barcelona;10;6;;1328;527;716;874;454;3;5;866;871
8;Barcelona;1;Barcelona;13;Barcelonès;08019;Barcelona;10;60;;998;311;470;667;331;0;3;664;667
8;Barcelona;1;Barcelona;13;Barcelonès;08019;Barcelona;10;61;;1326;551;771;996;330;3;4;989;993
8;Barcelona;1;Barcelona;13;Barcelonès;08019;Barcelona;10;62;;1107;464;684;830;277;1;1;828;829
8;Barcelona;1;Barcelona;13;Barcelonès;08019;Barcelona;10;63;;932;337;500;641;291;0;2;639;641
8;Barcelona;1;Barcelona;13;Barcelonès;08019;Barcelona;10;64;;1143;366;586;769;374;3;1;765;766
8;Barcelona;1;Barcelona;13;Barcelonès;08019;Barcelona;10;65;;1121;388;632;830;291;1;1;828;829
8;Barcelona;1;Barcelona;13;Barcelonès;08019;Barcelona;10;66;;1376;558;797;987;389;3;2;982;984
8;Barcelona;1;Barcelona;13;Barcelonès;08019;Barcelona;10;67;;1192;420;661;929;263;2;1;926;927
8;Barcelona;1;Barcelona;13;Barcelonès;08019;Barcelona;10;68;;1088;390;595;811;277;0;1;810;811
8;Barcelona;1;Barcelona;13;Barcelonès;08019;Barcelona;10;69;;1604;590;839;1093;511;2;1;1090;1091
8;Barcelona;1;Barcelona;13;Barcelonès;08019;Barcelona;10;7;;1050;437;658;819;231;2;1;816;817
8;Barcelona;1;Barcelona;13;Barcelonès;08019;Barcelona;10;70;;1183;399;661;825;358;0;1;824;825
8;Barcelona;1;Barcelona;13;Barcelonès;08019;Barcelona;10;71;;1360;564;818;1005;355;2;2;1001;1003
8;Barcelona;1;Barcelona;13;Barcelonès;08019;Barcelona;10;72;;1348;451;698;895;453;0;2;893;895
8;Barcelona;1;Barcelona;13;Barcelonès;08019;Barcelona;10;73;;1095;385;632;773;322;3;2;768;770
8;Barcelona;1;Barcelona;13;Barcelonès;08019;Barcelona;10;74;;1136;426;607;760;376;4;0;756;756
8;Barcelona;1;Barcelona;13;Barcelonès;08019;Barcelona;10;75;;1057;396;565;701;356;0;1;700;701
8;Barcelona;1;Barcelona;13;Barcelonès;08019;Barcelona;10;76;;1511;523;818;1112;399;0;1;1111;1112
8;Barcelona;1;Barcelona;13;Barcelonès;08019;Barcelona;10;77;;1185;454;692;928;257;1;3;924;927
8;Barcelona;1;Barcelona;13;Barcelonès;08019;Barcelona;10;78;;1458;599;824;1140;318;1;1;1138;1139
8;Barcelona;1;Barcelona;13;Barcelonès;08019;Barcelona;10;79;;1285;487;711;900;385;1;1;898;899
8;Barcelona;1;Barcelona;13;Barcelonès;08019;Barcelona;10;8;;1209;492;682;818;391;1;4;813;817
8;Barcelona;1;Barcelona;13;Barcelonès;08019;Barcelona;10;80;;1043;372;509;746;297;3;2;741;743
8;Barcelona;1;Barcelona;13;Barcelonès;08019;Barcelona;10;81;;1211;373;514;631;580;2;1;628;629
8;Barcelona;1;Barcelona;13;Barcelonès;08019;Barcelona;10;82;;896;203;295;322;574;0;3;319;322
8;Barcelona;1;Barcelona;13;Barcelonès;08019;Barcelona;10;83;;843;221;304;359;484;0;2;357;359
8;Barcelona;1;Barcelona;13;Barcelonès;08019;Barcelona;10;84;;903;276;383;449;454;1;1;447;448
8;Barcelona;1;Barcelona;13;Barcelonès;08019;Barcelona;10;85;;1075;323;456;534;541;4;3;527;530
8;Barcelona;1;Barcelona;13;Barcelonès;08019;Barcelona;10;86;;1166;381;537;598;568;0;1;597;598
8;Barcelona;1;Barcelona;13;Barcelonès;08019;Barcelona;10;87;;1159;290;451;534;625;2;1;531;532
8;Barcelona;1;Barcelona;13;Barcelonès;08019;Barcelona;10;88;;1308;480;667;826;482;0;0;826;826
8;Barcelona;1;Barcelona;13;Barcelonès;08019;Barcelona;10;89;;1244;285;400;509;735;1;1;507;508
8;Barcelona;1;Barcelona;13;Barcelonès;08019;Barcelona;10;9;;1172;484;648;819;353;1;6;812;818
8;Barcelona;1;Barcelona;13;Barcelonès;08019;Barcelona;10;90;;951;284;409;492;459;3;0;489;489
8;Barcelona;1;Barcelona;13;Barcelonès;08019;Barcelona;10;91;;1392;475;664;809;583;4;2;803;805
8;Barcelona;1;Barcelona;13;Barcelonès;08019;Barcelona;10;92;;1230;491;671;817;413;1;6;810;816
8;Barcelona;1;Barcelona;13;Barcelonès;08019;Barcelona;10;93;;908;350;518;634;274;0;1;633;634
8;Barcelona;1;Barcelona;13;Barcelonès;08019;Barcelona;10;94;;1736;564;816;1085;651;1;4;1080;1084
8;Barcelona;1;Barcelona;13;Barcelonès;08019;Barcelona;10;95;;887;291;394;518;369;3;5;510;515
8;Barcelona;1;Barcelona;13;Barcelonès;08019;Barcelona;10;96;;1105;391;586;781;324;3;2;776;778
8;Barcelona;1;Barcelona;13;Barcelonès;08019;Barcelona;10;97;;1140;394;595;756;384;1;1;754;755
8;Barcelona;1;Barcelona;13;Barcelonès;08019;Barcelona;10;98;;1512;560;827;1062;450;4;2;1056;1058
8;Barcelona;1;Barcelona;13;Barcelonès;08019;Barcelona;10;99;;880;233;343;456;424;1;0;455;455
8;Barcelona;1;Barcelona;13;Barcelonès;08019;Barcelona;2;1;;814;326;451;575;239;2;1;572;573
8;Barcelona;1;Barcelona;13;Barcelonès;08019;Barcelona;2;10;;848;333;484;631;217;0;2;629;631
8;Barcelona;1;Barcelona;13;Barcelonès;08019;Barcelona;2;100;;1020;392;599;755;265;0;1;754;755
8;Barcelona;1;Barcelona;13;Barcelonès;08019;Barcelona;2;101;;1510;523;747;979;531;0;5;974;979
8;Barcelona;1;Barcelona;13;Barcelonès;08019;Barcelona;2;102;;1040;409;578;754;286;0;3;751;754
8;Barcelona;1;Barcelona;13;Barcelonès;08019;Barcelona;2;103;;1129;403;584;752;377;2;1;749;750
8;Barcelona;1;Barcelona;13;Barcelonès;08019;Barcelona;2;104;;834;320;465;596;238;1;2;593;595
8;Barcelona;1;Barcelona;13;Barcelonès;08019;Barcelona;2;105;;1422;505;750;952;470;0;5;947;952
8;Barcelona;1;Barcelona;13;Barcelonès;08019;Barcelona;2;106;;990;353;506;687;303;4;15;668;683
8;Barcelona;1;Barcelona;13;Barcelonès;08019;Barcelona;2;107;;1210;479;715;912;298;3;0;909;909
8;Barcelona;1;Barcelona;13;Barcelonès;08019;Barcelona;2;108;;1206;452;671;865;341;0;2;863;865
8;Barcelona;1;Barcelona;13;Barcelonès;08019;Barcelona;2;109;;1551;582;784;1120;431;3;5;1112;1117
8;Barcelona;1;Barcelona;13;Barcelonès;08019;Barcelona;2;11;;850;307;473;614;236;0;4;610;614
8;Barcelona;1;Barcelona;13;Barcelonès;08019;Barcelona;2;110;;1295;453;754;888;407;3;2;883;885
8;Barcelona;1;Barcelona;13;Barcelonès;08019;Barcelona;2;111;;1307;449;624;839;468;2;5;832;837
8;Barcelona;1;Barcelona;13;Barcelonès;08019;Barcelona;2;112;;1032;444;649;760;272;3;2;755;757
8;Barcelona;1;Barcelona;13;Barcelonès;08019;Barcelona;2;113;;1601;585;911;1210;391;2;4;1204;1208
8;Barcelona;1;Barcelona;13;Barcelonès;08019;Barcelona;2;114;;1258;474;687;880;378;2;2;876;878
8;Barcelona;1;Barcelona;13;Barcelonès;08019;Barcelona;2;115;;943;327;526;673;270;0;2;671;673
8;Barcelona;1;Barcelona;13;Barcelonès;08019;Barcelona;2;116;;786;306;469;596;190;1;2;593;595
8;Barcelona;1;Barcelona;13;Barcelonès;08019;Barcelona;2;117;;889;338;484;619;270;2;3;614;617
8;Barcelona;1;Barcelona;13;Barcelonès;08019;Barcelona;2;118;;1068;342;562;772;296;1;3;768;771
8;Barcelona;1;Barcelona;13;Barcelonès;08019;Barcelona;2;119;;957;346;544;699;258;0;3;696;699
8;Barcelona;1;Barcelona;13;Barcelonès;08019;Barcelona;2;12;;1025;379;574;692;333;1;2;689;691
8;Barcelona;1;Barcelona;13;Barcelonès;08019;Barcelona;2;120;;910;352;510;619;291;2;4;613;617
8;Barcelona;1;Barcelona;13;Barcelonès;08019;Barcelona;2;121;;929;334;533;670;259;2;1;667;668
8;Barcelona;1;Barcelona;13;Barcelonès;08019;Barcelona;2;122;;830;313;440;580;250;0;4;576;580
8;Barcelona;1;Barcelona;13;Barcelonès;08019;Barcelona;2;123;;807;308;457;578;229;3;2;573;575
8;Barcelona;1;Barcelona;13;Barcelonès;08019;Barcelona;2;124;;847;332;496;644;203;3;4;637;641
8;Barcelona;1;Barcelona;13;Barcelonès;08019;Barcelona;2;125;;1286;492;729;915;371;2;4;909;913
8;Barcelona;1;Barcelona;13;Barcelonès;08019;Barcelona;2;126;;1122;390;585;805;317;1;1;803;804
8;Barcelona;1;Barcelona;13;Barcelonès;08019;Barcelona;2;127;;796;267;404;526;270;0;3;523;526
8;Barcelona;1;Barcelona;13;Barcelonès;08019;Barcelona;2;128;;900;280;422;558;342;2;4;552;556
8;Barcelona;1;Barcelona;13;Barcelonès;08019;Barcelona;2;129;;1125;392;580;775;350;1;3;771;774
8;Barcelona;1;Barcelona;13;Barcelonès;08019;Barcelona;2;13;;750;225;365;480;270;1;1;478;479
8;Barcelona;1;Barcelona;13;Barcelonès;08019;Barcelona;2;130;;900;347;547;719;181;2;3;714;717
8;Barcelona;1;Barcelona;13;Barcelonès;08019;Barcelona;2;131;;829;326;460;579;250;0;0;579;579
8;Barcelona;1;Barcelona;13;Barcelonès;08019;Barcelona;2;132;;847;308;464;578;269;2;4;572;576
8;Barcelona;1;Barcelona;13;Barcelonès;08019;Barcelona;2;133;;675;272;433;485;190;2;2;481;483
8;Barcelona;1;Barcelona;13;Barcelonès;08019;Barcelona;2;134;;1101;419;586;723;378;4;6;713;719
8;Barcelona;1;Barcelona;13;Barcelonès;08019;Barcelona;2;135;;1479;473;727;954;525;1;3;950;953
8;Barcelona;1;Barcelona;13;Barcelonès;08019;Barcelona;2;136;;693;277;386;467;226;4;1;462;463
8;Barcelona;1;Barcelona;13;Barcelonès;08019;Barcelona;2;137;;977;358;511;671;306;1;5;665;670
8;Barcelona;1;Barcelona;13;Barcelonès;08019;Barcelona;2;138;;1439;489;763;994;445;1;1;992;993
8;Barcelona;1;Barcelona;13;Barcelonès;08019;Barcelona;2;139;;1086;352;532;701;385;1;3;697;700
8;Barcelona;1;Barcelona;13;Barcelonès;08019;Barcelona;2;14;;845;286;416;544;301;1;3;540;543
8;Barcelona;1;Barcelona;13;Barcelonès;08019;Barcelona;2;140;;1405;536;806;986;419;0;4;982;986
8;Barcelona;1;Barcelona;13;Barcelonès;08019;Barcelona;2;141;;839;294;458;562;277;1;5;556;561
8;Barcelona;1;Barcelona;13;Barcelonès;08019;Barcelona;2;142;;1353;521;736;913;440;2;4;907;911
8;Barcelona;1;Barcelona;13;Barcelonès;08019;Barcelona;2;143;;910;338;493;642;268;2;3;637;640
8;Barcelona;1;Barcelona;13;Barcelonès;08019;Barcelona;2;144;;1050;377;566;753;297;3;2;748;750
8;Barcelona;1;Barcelona;13;Barcelonès;08019;Barcelona;2;145;;841;271;415;519;322;0;1;518;519
8;Barcelona;1;Barcelona;13;Barcelonès;08019;Barcelona;2;146;;843;338;394;600;243;2;2;596;598
8;Barcelona;1;Barcelona;13;Barcelonès;08019;Barcelona;2;147;;1525;600;889;1091;434;4;5;1082;1087
8;Barcelona;1;Barcelona;13;Barcelonès;08019;Barcelona;2;148;;1148;243;662;874;274;5;3;866;869
8;Barcelona;1;Barcelona;13;Barcelonès;08019;Barcelona;2;149;;1216;491;680;880;336;4;2;874;876
8;Barcelona;1;Barcelona;13;Barcelonès;08019;Barcelona;2;15;;1029;342;496;639;390;1;3;635;638
8;Barcelona;1;Barcelona;13;Barcelonès;08019;Barcelona;2;150;;985;326;502;616;369;0;1;615;616
8;Barcelona;1;Barcelona;13;Barcelonès;08019;Barcelona;2;151;;1042;379;552;676;366;0;1;675;676
8;Barcelona;1;Barcelona;13;Barcelonès;08019;Barcelona;2;152;;934;425;578;668;266;1;2;665;667
8;Barcelona;1;Barcelona;13;Barcelonès;08019;Barcelona;2;153;;981;384;559;705;276;2;4;699;703
8;Barcelona;1;Barcelona;13;Barcelonès;08019;Barcelona;2;154;;674;264;361;449;225;0;0;449;449
8;Barcelona;1;Barcelona;13;Barcelonès;08019;Barcelona;2;155;;1320;509;729;894;426;0;5;889;894
8;Barcelona;1;Barcelona;13;Barcelonès;08019;Barcelona;2;156;;958;356;495;636;322;0;4;632;636
8;Barcelona;1;Barcelona;13;Barcelonès;08019;Barcelona;2;157;;840;329;455;571;269;1;4;566;570
8;Barcelona;1;Barcelona;13;Barcelonès;08019;Barcelona;2;158;;1164;494;680;844;320;3;3;838;841
8;Barcelona;1;Barcelona;13;Barcelonès;08019;Barcelona;2;159;;1289;530;736;928;361;3;4;921;925
8;Barcelona;1;Barcelona;13;Barcelonès;08019;Barcelona;2;16;;1350;542;747;958;392;1;2;955;957
8;Barcelona;1;Barcelona;13;Barcelonès;08019;Barcelona;2;160;;1453;569;836;1029;424;1;3;1025;1028
8;Barcelona;1;Barcelona;13;Barcelonès;08019;Barcelona;2;161;;784;319;429;547;237;1;2;544;546
8;Barcelona;1;Barcelona;13;Barcelonès;08019;Barcelona;2;162;;982;378;536;652;330;1;1;650;651
8;Barcelona;1;Barcelona;13;Barcelonès;08019;Barcelona;2;163;;1259;398;615;857;402;1;0;856;856
8;Barcelona;1;Barcelona;13;Barcelonès;08019;Barcelona;2;164;;965;362;518;653;312;2;3;648;651
8;Barcelona;1;Barcelona;13;Barcelonès;08019;Barcelona;2;165;;1133;464;606;756;377;1;5;750;755
8;Barcelona;1;Barcelona;13;Barcelonès;08019;Barcelona;2;166;;1390;549;756;949;441;0;5;944;949
8;Barcelona;1;Barcelona;13;Barcelonès;08019;Barcelona;2;167;;1516;581;839;1058;458;3;4;1051;1055
8;Barcelona;1;Barcelona;13;Barcelonès;08019;Barcelona;2;168;;1510;539;812;1030;480;1;4;1025;1029
8;Barcelona;1;Barcelona;13;Barcelonès;08019;Barcelona;2;169;;1080;384;569;718;362;0;8;710;718
8;Barcelona;1;Barcelona;13;Barcelonès;08019;Barcelona;2;17;;1339;540;767;970;369;1;3;966;969
8;Barcelona;1;Barcelona;13;Barcelonès;08019;Barcelona;2;170;;1107;462;618;759;348;1;3;755;758
8;Barcelona;1;Barcelona;13;Barcelonès;08019;Barcelona;2;171;;1072;412;587;700;372;0;4;696;700
8;Barcelona;1;Barcelona;13;Barcelonès;08019;Barcelona;2;172;;1055;355;541;680;375;1;2;677;679
8;Barcelona;1;Barcelona;13;Barcelonès;08019;Barcelona;2;173;;1066;385;562;716;350;1;0;715;715
8;Barcelona;1;Barcelona;13;Barcelonès;08019;Barcelona;2;18;;1319;529;747;927;392;1;4;922;926
8;Barcelona;1;Barcelona;13;Barcelonès;08019;Barcelona;2;19;;1326;516;702;922;404;3;4;915;919
8;Barcelona;1;Barcelona;13;Barcelonès;08019;Barcelona;2;2;;1442;495;705;889;553;1;2;886;888
8;Barcelona;1;Barcelona;13;Barcelonès;08019;Barcelona;2;20;;930;310;476;624;306;1;3;620;623
8;Barcelona;1;Barcelona;13;Barcelonès;08019;Barcelona;2;21;;1072;413;578;718;354;1;0;717;717
8;Barcelona;1;Barcelona;13;Barcelonès;08019;Barcelona;2;22;;900;345;505;615;285;0;2;613;615
8;Barcelona;1;Barcelona;13;Barcelonès;08019;Barcelona;2;23;;846;333;447;587;259;0;5;582;587
8;Barcelona;1;Barcelona;13;Barcelonès;08019;Barcelona;2;24;;744;279;377;493;251;1;1;491;492
8;Barcelona;1;Barcelona;13;Barcelonès;08019;Barcelona;2;25;;811;286;437;537;274;1;2;534;536
8;Barcelona;1;Barcelona;13;Barcelonès;08019;Barcelona;2;26;;1485;566;838;1064;421;4;9;1051;1060
8;Barcelona;1;Barcelona;13;Barcelonès;08019;Barcelona;2;27;;1451;615;903;1049;402;2;3;1044;1047
8;Barcelona;1;Barcelona;13;Barcelonès;08019;Barcelona;2;28;;1453;530;879;998;455;2;8;988;996
8;Barcelona;1;Barcelona;13;Barcelonès;08019;Barcelona;2;29;;906;351;501;631;275;1;1;629;630
8;Barcelona;1;Barcelona;13;Barcelonès;08019;Barcelona;2;3;;888;276;469;611;277;4;3;604;607
8;Barcelona;1;Barcelona;13;Barcelonès;08019;Barcelona;2;30;;860;349;468;582;278;1;2;579;581
8;Barcelona;1;Barcelona;13;Barcelonès;08019;Barcelona;2;31;;796;335;457;584;212;0;6;578;584
8;Barcelona;1;Barcelona;13;Barcelonès;08019;Barcelona;2;32;;917;336;495;629;288;0;1;628;629
8;Barcelona;1;Barcelona;13;Barcelonès;08019;Barcelona;2;33;;862;336;487;628;234;1;4;623;627
8;Barcelona;1;Barcelona;13;Barcelonès;08019;Barcelona;2;34;;818;294;430;531;287;0;0;531;531
8;Barcelona;1;Barcelona;13;Barcelonès;08019;Barcelona;2;35;;950;354;533;667;283;4;4;659;663
8;Barcelona;1;Barcelona;13;Barcelonès;08019;Barcelona;2;36;;899;356;512;652;247;3;3;646;649
8;Barcelona;1;Barcelona;13;Barcelonès;08019;Barcelona;2;37;;934;385;549;691;243;0;1;690;691
8;Barcelona;1;Barcelona;13;Barcelonès;08019;Barcelona;2;38;;1197;437;676;894;303;2;3;889;892
8;Barcelona;1;Barcelona;13;Barcelonès;08019;Barcelona;2;39;;1225;468;671;849;376;2;2;845;847
8;Barcelona;1;Barcelona;13;Barcelonès;08019;Barcelona;2;4;;927;357;524;643;284;0;4;639;643
8;Barcelona;1;Barcelona;13;Barcelonès;08019;Barcelona;2;40;;1047;367;528;663;384;2;6;655;661
8;Barcelona;1;Barcelona;13;Barcelonès;08019;Barcelona;2;41;;1221;402;607;821;400;1;3;817;820
8;Barcelona;1;Barcelona;13;Barcelonès;08019;Barcelona;2;42;;1302;500;741;936;366;3;3;930;933
8;Barcelona;1;Barcelona;13;Barcelonès;08019;Barcelona;2;43;;1075;389;604;808;267;1;4;803;807
8;Barcelona;1;Barcelona;13;Barcelonès;08019;Barcelona;2;44;;842;290;458;580;262;2;0;578;578
8;Barcelona;1;Barcelona;13;Barcelonès;08019;Barcelona;2;45;;824;308;456;580;244;2;1;577;578
8;Barcelona;1;Barcelona;13;Barcelonès;08019;Barcelona;2;46;;1320;474;701;880;440;4;1;875;876
8;Barcelona;1;Barcelona;13;Barcelonès;08019;Barcelona;2;47;;1332;479;718;915;417;0;2;913;915
8;Barcelona;1;Barcelona;13;Barcelonès;08019;Barcelona;2;48;;832;250;416;525;307;1;3;521;524
8;Barcelona;1;Barcelona;13;Barcelonès;08019;Barcelona;2;49;;1350;449;656;839;511;2;3;834;837
8;Barcelona;1;Barcelona;13;Barcelonès;08019;Barcelona;2;5;;1485;600;883;1135;350;0;2;1133;1135
8;Barcelona;1;Barcelona;13;Barcelonès;08019;Barcelona;2;50;;1105;380;563;730;375;1;1;728;729
8;Barcelona;1;Barcelona;13;Barcelonès;08019;Barcelona;2;51;;1185;444;617;767;418;1;2;764;766
8;Barcelona;1;Barcelona;13;Barcelonès;08019;Barcelona;2;52;;1189;464;653;838;351;1;2;835;837
8;Barcelona;1;Barcelona;13;Barcelonès;08019;Barcelona;2;53;;1227;446;651;847;380;2;2;843;845
8;Barcelona;1;Barcelona;13;Barcelonès;08019;Barcelona;2;54;;1303;513;743;949;354;2;1;946;947
8;Barcelona;1;Barcelona;13;Barcelonès;08019;Barcelona;2;55;;1306;442;731;897;409;0;4;893;897
8;Barcelona;1;Barcelona;13;Barcelonès;08019;Barcelona;2;56;;1026;318;522;705;321;2;2;701;703
8;Barcelona;1;Barcelona;13;Barcelonès;08019;Barcelona;2;57;;904;342;530;672;232;1;5;666;671
8;Barcelona;1;Barcelona;13;Barcelonès;08019;Barcelona;2;58;;1035;361;540;742;293;1;1;740;741
8;Barcelona;1;Barcelona;13;Barcelonès;08019;Barcelona;2;59;;1176;459;658;858;318;3;4;851;855
8;Barcelona;1;Barcelona;13;Barcelonès;08019;Barcelona;2;6;;1154;487;720;906;248;0;0;906;906
8;Barcelona;1;Barcelona;13;Barcelonès;08019;Barcelona;2;60;;1179;432;658;830;349;0;2;828;830
8;Barcelona;1;Barcelona;13;Barcelonès;08019;Barcelona;2;61;;912;352;524;643;269;0;2;641;643
8;Barcelona;1;Barcelona;13;Barcelonès;08019;Barcelona;2;62;;1047;403;597;769;278;1;2;766;768
8;Barcelona;1;Barcelona;13;Barcelonès;08019;Barcelona;2;63;;904;333;492;652;252;0;1;651;652
8;Barcelona;1;Barcelona;13;Barcelonès;08019;Barcelona;2;64;;925;365;562;728;197;2;0;726;726
8;Barcelona;1;Barcelona;13;Barcelonès;08019;Barcelona;2;65;;1283;446;696;899;384;0;7;892;899
8;Barcelona;1;Barcelona;13;Barcelonès;08019;Barcelona;2;66;;1353;536;770;951;402;0;3;948;951
8;Barcelona;1;Barcelona;13;Barcelonès;08019;Barcelona;2;67;;1066;376;565;735;331;1;3;731;734
8;Barcelona;1;Barcelona;13;Barcelonès;08019;Barcelona;2;68;;1106;411;632;798;308;1;4;793;797
8;Barcelona;1;Barcelona;13;Barcelonès;08019;Barcelona;2;69;;925;360;554;703;222;3;2;698;700
8;Barcelona;1;Barcelona;13;Barcelonès;08019;Barcelona;2;7;;920;342;509;649;271;0;3;646;649
8;Barcelona;1;Barcelona;13;Barcelonès;08019;Barcelona;2;70;;888;311;479;647;241;1;3;643;646
8;Barcelona;1;Barcelona;13;Barcelonès;08019;Barcelona;2;71;;1187;477;706;916;271;2;2;912;914
8;Barcelona;1;Barcelona;13;Barcelonès;08019;Barcelona;2;72;;878;306;477;642;236;0;2;640;642
8;Barcelona;1;Barcelona;13;Barcelonès;08019;Barcelona;2;73;;1118;371;551;776;342;0;2;774;776
8;Barcelona;1;Barcelona;13;Barcelonès;08019;Barcelona;2;74;;772;279;404;547;225;1;5;541;546
8;Barcelona;1;Barcelona;13;Barcelonès;08019;Barcelona;2;75;;813;288;440;597;216;0;3;594;597
8;Barcelona;1;Barcelona;13;Barcelonès;08019;Barcelona;2;76;;1081;418;591;802;279;2;0;800;800
8;Barcelona;1;Barcelona;13;Barcelonès;08019;Barcelona;2;77;;951;310;487;635;316;1;3;631;634
8;Barcelona;1;Barcelona;13;Barcelonès;08019;Barcelona;2;78;;870;312;476;589;281;1;2;586;588
8;Barcelona;1;Barcelona;13;Barcelonès;08019;Barcelona;2;79;;839;295;426;570;269;0;0;570;570
8;Barcelona;1;Barcelona;13;Barcelonès;08019;Barcelona;2;8;;1338;518;747;979;359;0;1;978;979
8;Barcelona;1;Barcelona;13;Barcelonès;08019;Barcelona;2;80;;985;314;503;670;315;2;5;663;668
8;Barcelona;1;Barcelona;13;Barcelonès;08019;Barcelona;2;81;;1436;482;734;1032;404;3;3;1026;1029
8;Barcelona;1;Barcelona;13;Barcelonès;08019;Barcelona;2;82;;633;225;307;422;211;0;1;421;422
8;Barcelona;1;Barcelona;13;Barcelonès;08019;Barcelona;2;83;;1183;429;654;883;300;0;2;881;883
8;Barcelona;1;Barcelona;13;Barcelonès;08019;Barcelona;2;84;;1415;447;758;998;417;1;7;990;997
8;Barcelona;1;Barcelona;13;Barcelonès;08019;Barcelona;2;85;;980;328;508;676;304;0;1;675;676
8;Barcelona;1;Barcelona;13;Barcelonès;08019;Barcelona;2;86;;972;349;531;703;269;1;5;697;702
8;Barcelona;1;Barcelona;13;Barcelonès;08019;Barcelona;2;87;;1009;359;535;737;272;0;3;734;737
8;Barcelona;1;Barcelona;13;Barcelonès;08019;Barcelona;2;88;;1158;476;699;829;329;2;3;824;827
8;Barcelona;1;Barcelona;13;Barcelonès;08019;Barcelona;2;89;;1270;434;692;898;372;2;4;892;896
8;Barcelona;1;Barcelona;13;Barcelonès;08019;Barcelona;2;9;;1231;495;724;897;334;0;2;895;897
8;Barcelona;1;Barcelona;13;Barcelonès;08019;Barcelona;2;90;;1077;319;510;722;355;2;1;719;720
8;Barcelona;1;Barcelona;13;Barcelonès;08019;Barcelona;2;91;;1194;420;626;825;369;3;1;821;822
8;Barcelona;1;Barcelona;13;Barcelonès;08019;Barcelona;2;92;;1184;394;596;774;410;3;1;770;771
8;Barcelona;1;Barcelona;13;Barcelonès;08019;Barcelona;2;93;;1112;373;577;767;345;0;7;760;767
8;Barcelona;1;Barcelona;13;Barcelonès;08019;Barcelona;2;94;;1036;351;550;724;312;4;8;712;720
8;Barcelona;1;Barcelona;13;Barcelonès;08019;Barcelona;2;95;;1058;374;525;722;336;0;3;719;722
8;Barcelona;1;Barcelona;13;Barcelonès;08019;Barcelona;2;96;;959;340;500;651;308;2;1;648;649
8;Barcelona;1;Barcelona;13;Barcelonès;08019;Barcelona;2;97;;710;222;342;466;244;0;2;464;466
8;Barcelona;1;Barcelona;13;Barcelonès;08019;Barcelona;2;98;;1020;344;534;665;355;1;1;663;664
8;Barcelona;1;Barcelona;13;Barcelonès;08019;Barcelona;2;99;;1071;368;596;737;334;2;1;734;735
8;Barcelona;1;Barcelona;13;Barcelonès;08019;Barcelona;3;1;;1173;368;608;740;433;2;1;737;738
8;Barcelona;1;Barcelona;13;Barcelonès;08019;Barcelona;3;10;;1090;387;539;639;451;0;0;639;639
8;Barcelona;1;Barcelona;13;Barcelonès;08019;Barcelona;3;100;;896;255;407;619;277;0;2;617;619
8;Barcelona;1;Barcelona;13;Barcelonès;08019;Barcelona;3;101;;1385;542;773;736;649;0;1;735;736
8;Barcelona;1;Barcelona;13;Barcelonès;08019;Barcelona;3;102;;918;356;502;646;272;2;1;643;644
8;Barcelona;1;Barcelona;13;Barcelonès;08019;Barcelona;3;103;;953;352;537;654;299;1;2;651;653
8;Barcelona;1;Barcelona;13;Barcelonès;08019;Barcelona;3;104;;971;334;489;624;347;0;1;623;624
8;Barcelona;1;Barcelona;13;Barcelonès;08019;Barcelona;3;105;;810;300;439;557;253;0;1;556;557
8;Barcelona;1;Barcelona;13;Barcelonès;08019;Barcelona;3;106;;880;346;466;568;312;2;1;565;566
8;Barcelona;1;Barcelona;13;Barcelonès;08019;Barcelona;3;107;;1135;471;665;818;317;4;2;812;814
8;Barcelona;1;Barcelona;13;Barcelonès;08019;Barcelona;3;108;;1088;418;588;742;346;3;3;736;739
8;Barcelona;1;Barcelona;13;Barcelonès;08019;Barcelona;3;109;;1087;429;642;810;277;0;4;806;810
8;Barcelona;1;Barcelona;13;Barcelonès;08019;Barcelona;3;11;;977;299;432;546;431;0;2;544;546
8;Barcelona;1;Barcelona;13;Barcelonès;08019;Barcelona;3;110;;1079;400;573;735;344;1;1;733;734
8;Barcelona;1;Barcelona;13;Barcelonès;08019;Barcelona;3;111;;920;367;508;653;267;0;3;650;653
8;Barcelona;1;Barcelona;13;Barcelonès;08019;Barcelona;3;112;;1432;568;833;1047;385;0;6;1041;1047
8;Barcelona;1;Barcelona;13;Barcelonès;08019;Barcelona;3;113;;1173;461;640;826;347;3;2;821;823
8;Barcelona;1;Barcelona;13;Barcelonès;08019;Barcelona;3;114;;1155;396;618;812;343;2;4;806;810
8;Barcelona;1;Barcelona;13;Barcelonès;08019;Barcelona;3;12;;1247;382;545;702;545;4;1;697;698
8;Barcelona;1;Barcelona;13;Barcelonès;08019;Barcelona;3;13;;1007;317;484;583;424;1;0;582;582
8;Barcelona;1;Barcelona;13;Barcelonès;08019;Barcelona;3;14;;1005;311;461;564;441;1;8;555;563
8;Barcelona;1;Barcelona;13;Barcelonès;08019;Barcelona;3;15;;1680;541;774;971;709;4;0;967;967
8;Barcelona;1;Barcelona;13;Barcelonès;08019;Barcelona;3;16;;662;180;307;377;285;0;0;377;377
8;Barcelona;1;Barcelona;13;Barcelonès;08019;Barcelona;3;17;;853;234;338;429;424;1;1;427;428
8;Barcelona;1;Barcelona;13;Barcelonès;08019;Barcelona;3;18;;1062;343;490;601;461;0;2;599;601
8;Barcelona;1;Barcelona;13;Barcelonès;08019;Barcelona;3;19;;869;260;412;500;369;3;4;493;497
8;Barcelona;1;Barcelona;13;Barcelonès;08019;Barcelona;3;2;;1239;411;602;751;488;2;5;744;749
8;Barcelona;1;Barcelona;13;Barcelonès;08019;Barcelona;3;20;;878;303;457;563;315;1;3;559;562
8;Barcelona;1;Barcelona;13;Barcelonès;08019;Barcelona;3;21;;837;306;426;525;312;4;1;520;521
8;Barcelona;1;Barcelona;13;Barcelonès;08019;Barcelona;3;211;;1146;336;532;728;418;0;8;720;728
8;Barcelona;1;Barcelona;13;Barcelonès;08019;Barcelona;3;212;;1736;601;872;1090;646;1;3;1086;1089
8;Barcelona;1;Barcelona;13;Barcelonès;08019;Barcelona;3;213;;1540;427;605;793;747;2;3;788;791
8;Barcelona;1;Barcelona;13;Barcelonès;08019;Barcelona;3;22;;971;296;445;550;421;2;0;548;548
8;Barcelona;1;Barcelona;13;Barcelonès;08019;Barcelona;3;23;;1148;398;559;672;476;2;1;669;670
8;Barcelona;1;Barcelona;13;Barcelonès;08019;Barcelona;3;24;;1261;409;576;742;519;1;2;739;741
8;Barcelona;1;Barcelona;13;Barcelonès;08019;Barcelona;3;25;;909;171;291;365;544;0;0;365;365
8;Barcelona;1;Barcelona;13;Barcelonès;08019;Barcelona;3;26;;779;303;430;547;232;4;1;542;543
8;Barcelona;1;Barcelona;13;Barcelonès;08019;Barcelona;3;27;;1344;377;545;822;522;4;1;817;818
8;Barcelona;1;Barcelona;13;Barcelonès;08019;Barcelona;3;28;;1613;533;817;1093;520;0;4;1089;1093
8;Barcelona;1;Barcelona;13;Barcelonès;08019;Barcelona;3;29;;1003;317;504;606;397;2;2;602;604
8;Barcelona;1;Barcelona;13;Barcelonès;08019;Barcelona;3;3;;986;206;425;553;433;0;1;552;553
8;Barcelona;1;Barcelona;13;Barcelonès;08019;Barcelona;3;30;;1167;421;595;744;423;4;2;738;740
8;Barcelona;1;Barcelona;13;Barcelonès;08019;Barcelona;3;31;;1890;579;825;1081;809;9;1;1071;1072
8;Barcelona;1;Barcelona;13;Barcelonès;08019;Barcelona;3;32;;1138;290;472;554;584;3;1;550;551
8;Barcelona;1;Barcelona;13;Barcelonès;08019;Barcelona;3;33;;875;277;345;412;463;0;0;412;412
8;Barcelona;1;Barcelona;13;Barcelonès;08019;Barcelona;3;34;;1133;339;495;653;480;1;6;646;652
8;Barcelona;1;Barcelona;13;Barcelonès;08019;Barcelona;3;35;;1754;598;820;1130;624;4;2;1124;1126
8;Barcelona;1;Barcelona;13;Barcelonès;08019;Barcelona;3;36;;1705;656;913;1170;535;4;2;1164;1166
8;Barcelona;1;Barcelona;13;Barcelonès;08019;Barcelona;3;37;;852;272;405;556;296;1;2;553;555
8;Barcelona;1;Barcelona;13;Barcelonès;08019;Barcelona;3;38;;733;217;300;367;366;1;1;365;366
8;Barcelona;1;Barcelona;13;Barcelonès;08019;Barcelona;3;39;;1609;516;615;781;828;8;2;771;773
8;Barcelona;1;Barcelona;13;Barcelonès;08019;Barcelona;3;4;;1055;310;546;695;360;3;1;691;692
8;Barcelona;1;Barcelona;13;Barcelonès;08019;Barcelona;3;40;;1204;460;644;787;417;0;1;786;787
8;Barcelona;1;Barcelona;13;Barcelonès;08019;Barcelona;3;41;;985;344;486;593;392;2;2;589;591
8;Barcelona;1;Barcelona;13;Barcelonès;08019;Barcelona;3;42;;942;320;496;607;335;2;5;600;605
8;Barcelona;1;Barcelona;13;Barcelonès;08019;Barcelona;3;43;;1199;370;537;699;500;2;0;697;697
8;Barcelona;1;Barcelona;13;Barcelonès;08019;Barcelona;3;44;;1224;415;619;772;452;0;2;770;772
8;Barcelona;1;Barcelona;13;Barcelonès;08019;Barcelona;3;45;;712;267;396;489;223;0;2;487;489
8;Barcelona;1;Barcelona;13;Barcelonès;08019;Barcelona;3;46;;1100;396;602;785;315;1;5;779;784
8;Barcelona;1;Barcelona;13;Barcelonès;08019;Barcelona;3;47;;1244;477;629;779;465;0;4;775;779
8;Barcelona;1;Barcelona;13;Barcelonès;08019;Barcelona;3;48;;974;298;538;710;264;3;1;706;707
8;Barcelona;1;Barcelona;13;Barcelonès;08019;Barcelona;3;49;;1119;410;609;752;367;3;2;747;749
8;Barcelona;1;Barcelona;13;Barcelonès;08019;Barcelona;3;5;;806;289;396;504;302;0;6;498;504
8;Barcelona;1;Barcelona;13;Barcelonès;08019;Barcelona;3;50;;1141;445;607;766;375;0;2;764;766
8;Barcelona;1;Barcelona;13;Barcelonès;08019;Barcelona;3;51;;1129;326;506;654;475;0;3;651;654
8;Barcelona;1;Barcelona;13;Barcelonès;08019;Barcelona;3;52;;848;262;365;494;354;1;1;492;493
8;Barcelona;1;Barcelona;13;Barcelonès;08019;Barcelona;3;53;;1315;443;621;834;481;1;0;833;833
8;Barcelona;1;Barcelona;13;Barcelonès;08019;Barcelona;3;54;;1235;492;686;849;386;0;2;847;849
8;Barcelona;1;Barcelona;13;Barcelonès;08019;Barcelona;3;55;;1166;475;626;769;397;2;2;765;767
8;Barcelona;1;Barcelona;13;Barcelonès;08019;Barcelona;3;56;;633;253;373;427;206;0;1;426;427
8;Barcelona;1;Barcelona;13;Barcelonès;08019;Barcelona;3;57;;1175;468;645;797;378;7;0;790;790
8;Barcelona;1;Barcelona;13;Barcelonès;08019;Barcelona;3;58;;1203;444;626;797;406;0;2;795;797
8;Barcelona;1;Barcelona;13;Barcelonès;08019;Barcelona;3;59;;878;305;461;572;306;0;0;572;572
8;Barcelona;1;Barcelona;13;Barcelonès;08019;Barcelona;3;6;;850;284;405;535;315;4;2;529;531
8;Barcelona;1;Barcelona;13;Barcelonès;08019;Barcelona;3;60;;1087;444;628;768;319;1;1;766;767
8;Barcelona;1;Barcelona;13;Barcelonès;08019;Barcelona;3;61;;829;328;450;552;277;0;2;550;552
8;Barcelona;1;Barcelona;13;Barcelonès;08019;Barcelona;3;62;;1203;498;666;844;359;3;1;840;841
8;Barcelona;1;Barcelona;13;Barcelonès;08019;Barcelona;3;63;;1198;430;652;793;405;1;0;792;792
8;Barcelona;1;Barcelona;13;Barcelonès;08019;Barcelona;3;64;;943;334;498;606;337;2;3;601;604
8;Barcelona;1;Barcelona;13;Barcelonès;08019;Barcelona;3;65;;1147;425;588;744;403;2;1;741;742
8;Barcelona;1;Barcelona;13;Barcelonès;08019;Barcelona;3;66;;1680;628;914;1113;567;2;2;1109;1111
8;Barcelona;1;Barcelona;13;Barcelonès;08019;Barcelona;3;67;;1285;482;696;859;426;0;1;858;859
8;Barcelona;1;Barcelona;13;Barcelonès;08019;Barcelona;3;68;;887;343;476;540;347;1;5;534;539
8;Barcelona;1;Barcelona;13;Barcelonès;08019;Barcelona;3;69;;904;365;507;601;303;0;3;598;601
8;Barcelona;1;Barcelona;13;Barcelonès;08019;Barcelona;3;7;;1055;339;501;616;439;3;4;609;613
8;Barcelona;1;Barcelona;13;Barcelonès;08019;Barcelona;3;70;;946;335;487;565;381;3;0;562;562
8;Barcelona;1;Barcelona;13;Barcelonès;08019;Barcelona;3;71;;878;308;440;529;349;0;2;527;529
8;Barcelona;1;Barcelona;13;Barcelonès;08019;Barcelona;3;72;;972;351;491;636;336;1;1;634;635
8;Barcelona;1;Barcelona;13;Barcelonès;08019;Barcelona;3;73;;1210;496;698;828;382;1;0;827;827
8;Barcelona;1;Barcelona;13;Barcelonès;08019;Barcelona;3;74;;1287;475;673;812;475;1;2;809;811
8;Barcelona;1;Barcelona;13;Barcelonès;08019;Barcelona;3;75;;1195;413;607;779;416;2;5;772;777
8;Barcelona;1;Barcelona;13;Barcelonès;08019;Barcelona;3;76;;772;271;381;479;293;2;1;476;477
8;Barcelona;1;Barcelona;13;Barcelonès;08019;Barcelona;3;77;;943;371;515;612;331;0;0;612;612
8;Barcelona;1;Barcelona;13;Barcelonès;08019;Barcelona;3;78;;1172;413;577;753;419;2;1;750;751
8;Barcelona;1;Barcelona;13;Barcelonès;08019;Barcelona;3;79;;1166;389;553;701;465;2;1;698;699
8;Barcelona;1;Barcelona;13;Barcelonès;08019;Barcelona;3;8;;756;263;372;451;305;0;0;451;451
8;Barcelona;1;Barcelona;13;Barcelonès;08019;Barcelona;3;80;;1160;388;554;717;443;1;4;712;716
8;Barcelona;1;Barcelona;13;Barcelonès;08019;Barcelona;3;81;;1308;484;650;834;474;0;2;832;834
8;Barcelona;1;Barcelona;13;Barcelonès;08019;Barcelona;3;82;;1369;488;735;948;421;0;2;946;948
8;Barcelona;1;Barcelona;13;Barcelonès;08019;Barcelona;3;83;;1056;416;545;712;344;4;0;708;708
8;Barcelona;1;Barcelona;13;Barcelonès;08019;Barcelona;3;84;;1097;396;585;784;313;1;2;781;783
8;Barcelona;1;Barcelona;13;Barcelonès;08019;Barcelona;3;85;;967;362;515;652;315;1;2;649;651
8;Barcelona;1;Barcelona;13;Barcelonès;08019;Barcelona;3;86;;1006;415;604;767;239;0;1;766;767
8;Barcelona;1;Barcelona;13;Barcelonès;08019;Barcelona;3;87;;1113;374;635;811;302;1;6;804;810
8;Barcelona;1;Barcelona;13;Barcelonès;08019;Barcelona;3;88;;1022;354;590;732;290;2;3;727;730
8;Barcelona;1;Barcelona;13;Barcelonès;08019;Barcelona;3;89;;1002;435;583;744;258;1;3;740;743
8;Barcelona;1;Barcelona;13;Barcelonès;08019;Barcelona;3;9;;805;274;388;501;304;0;1;500;501
8;Barcelona;1;Barcelona;13;Barcelonès;08019;Barcelona;3;90;;809;188;320;614;195;0;3;611;614
8;Barcelona;1;Barcelona;13;Barcelonès;08019;Barcelona;3;91;;1045;370;571;737;308;3;2;732;734
8;Barcelona;1;Barcelona;13;Barcelonès;08019;Barcelona;3;92;;891;315;474;605;286;2;1;602;603
8;Barcelona;1;Barcelona;13;Barcelonès;08019;Barcelona;3;93;;1197;453;647;848;349;0;4;844;848
8;Barcelona;1;Barcelona;13;Barcelonès;08019;Barcelona;3;94;;913;357;478;612;301;1;1;610;611
8;Barcelona;1;Barcelona;13;Barcelonès;08019;Barcelona;3;95;;1170;448;618;776;394;1;0;775;775
8;Barcelona;1;Barcelona;13;Barcelonès;08019;Barcelona;3;96;;1049;357;542;688;361;0;1;687;688
8;Barcelona;1;Barcelona;13;Barcelonès;08019;Barcelona;3;97;;1002;270;503;560;442;1;1;558;559
8;Barcelona;1;Barcelona;13;Barcelonès;08019;Barcelona;3;98;;922;307;463;569;353;1;0;568;568
8;Barcelona;1;Barcelona;13;Barcelonès;08019;Barcelona;3;99;;695;297;387;480;215;0;2;478;480
8;Barcelona;1;Barcelona;13;Barcelonès;08019;Barcelona;4;1;;889;314;490;633;256;0;3;630;633
8;Barcelona;1;Barcelona;13;Barcelonès;08019;Barcelona;4;10;;692;349;483;519;173;0;2;517;519
8;Barcelona;1;Barcelona;13;Barcelonès;08019;Barcelona;4;11;;1302;545;774;1027;275;0;4;1023;1027
8;Barcelona;1;Barcelona;13;Barcelonès;08019;Barcelona;4;12;;1150;458;648;845;305;2;1;842;843
8;Barcelona;1;Barcelona;13;Barcelonès;08019;Barcelona;4;13;;1003;381;555;741;262;3;0;738;738
8;Barcelona;1;Barcelona;13;Barcelonès;08019;Barcelona;4;14;;654;226;335;438;216;2;3;433;436
8;Barcelona;1;Barcelona;13;Barcelonès;08019;Barcelona;4;15;;1493;577;878;1124;369;0;2;1122;1124
8;Barcelona;1;Barcelona;13;Barcelonès;08019;Barcelona;4;16;;857;354;543;654;203;2;0;652;652
8;Barcelona;1;Barcelona;13;Barcelonès;08019;Barcelona;4;17;;942;336;450;665;277;2;3;660;663
8;Barcelona;1;Barcelona;13;Barcelonès;08019;Barcelona;4;18;;1177;393;620;816;361;0;2;814;816
8;Barcelona;1;Barcelona;13;Barcelonès;08019;Barcelona;4;19;;1040;362;558;745;295;2;3;740;743
8;Barcelona;1;Barcelona;13;Barcelonès;08019;Barcelona;4;2;;1508;585;972;1132;376;2;4;1126;1130
8;Barcelona;1;Barcelona;13;Barcelonès;08019;Barcelona;4;20;;1083;272;453;771;312;0;3;768;771
8;Barcelona;1;Barcelona;13;Barcelonès;08019;Barcelona;4;21;;968;367;552;724;244;0;3;721;724
8;Barcelona;1;Barcelona;13;Barcelonès;08019;Barcelona;4;22;;1164;401;599;806;358;0;2;804;806
8;Barcelona;1;Barcelona;13;Barcelonès;08019;Barcelona;4;23;;790;268;514;594;196;0;1;593;594
8;Barcelona;1;Barcelona;13;Barcelonès;08019;Barcelona;4;24;;799;353;429;587;212;1;3;583;586
8;Barcelona;1;Barcelona;13;Barcelonès;08019;Barcelona;4;25;;876;323;467;642;234;0;4;638;642
8;Barcelona;1;Barcelona;13;Barcelonès;08019;Barcelona;4;26;;958;349;549;711;247;3;5;703;708
8;Barcelona;1;Barcelona;13;Barcelonès;08019;Barcelona;4;27;;954;310;505;678;276;0;6;672;678
8;Barcelona;1;Barcelona;13;Barcelonès;08019;Barcelona;4;28;;997;410;576;738;259;6;0;732;732
8;Barcelona;1;Barcelona;13;Barcelonès;08019;Barcelona;4;29;;931;384;537;713;218;1;3;709;712
8;Barcelona;1;Barcelona;13;Barcelonès;08019;Barcelona;4;3;;822;321;481;598;224;1;0;597;597
8;Barcelona;1;Barcelona;13;Barcelonès;08019;Barcelona;4;30;;1389;645;863;1067;322;4;1;1062;1063
8;Barcelona;1;Barcelona;13;Barcelonès;08019;Barcelona;4;31;;1248;443;627;807;441;1;1;805;806
8;Barcelona;1;Barcelona;13;Barcelonès;08019;Barcelona;4;32;;1213;454;720;906;307;1;4;901;905
8;Barcelona;1;Barcelona;13;Barcelonès;08019;Barcelona;4;33;;880;346;509;646;234;1;2;643;645
8;Barcelona;1;Barcelona;13;Barcelonès;08019;Barcelona;4;34;;1207;525;737;974;233;3;5;966;971
8;Barcelona;1;Barcelona;13;Barcelonès;08019;Barcelona;4;35;;1107;413;645;855;252;1;6;848;854
8;Barcelona;1;Barcelona;13;Barcelonès;08019;Barcelona;4;36;;1249;534;700;878;371;1;3;874;877
8;Barcelona;1;Barcelona;13;Barcelonès;08019;Barcelona;4;37;;1621;644;941;1206;415;2;7;1197;1204
8;Barcelona;1;Barcelona;13;Barcelonès;08019;Barcelona;4;38;;1018;407;596;741;277;0;4;737;741
8;Barcelona;1;Barcelona;13;Barcelonès;08019;Barcelona;4;39;;876;304;445;617;259;0;6;611;617
8;Barcelona;1;Barcelona;13;Barcelonès;08019;Barcelona;4;4;;758;300;432;554;204;2;3;549;552
8;Barcelona;1;Barcelona;13;Barcelonès;08019;Barcelona;4;40;;1097;359;530;678;419;1;6;671;677
8;Barcelona;1;Barcelona;13;Barcelonès;08019;Barcelona;4;41;;941;357;527;631;310;3;3;625;628
8;Barcelona;1;Barcelona;13;Barcelonès;08019;Barcelona;4;42;;1348;519;879;913;435;0;3;910;913
8;Barcelona;1;Barcelona;13;Barcelonès;08019;Barcelona;4;43;;1330;545;789;1024;306;2;2;1020;1022
8;Barcelona;1;Barcelona;13;Barcelonès;08019;Barcelona;4;44;;1237;475;642;823;414;1;14;808;822
8;Barcelona;1;Barcelona;13;Barcelonès;08019;Barcelona;4;45;;1026;397;560;717;309;0;4;713;717
8;Barcelona;1;Barcelona;13;Barcelonès;08019;Barcelona;4;46;;1949;758;1216;1459;490;2;1;1456;1457
8;Barcelona;1;Barcelona;13;Barcelonès;08019;Barcelona;4;47;;1393;573;790;1023;370;5;7;1011;1018
8;Barcelona;1;Barcelona;13;Barcelonès;08019;Barcelona;4;48;;1215;464;721;896;319;4;0;892;892
8;Barcelona;1;Barcelona;13;Barcelonès;08019;Barcelona;4;49;;850;302;461;627;223;0;0;627;627
8;Barcelona;1;Barcelona;13;Barcelonès;08019;Barcelona;4;5;;971;408;571;700;271;0;1;699;700
8;Barcelona;1;Barcelona;13;Barcelonès;08019;Barcelona;4;50;;1492;525;792;1102;390;1;0;1101;1101
8;Barcelona;1;Barcelona;13;Barcelonès;08019;Barcelona;4;51;;1203;396;593;837;366;4;2;831;833
8;Barcelona;1;Barcelona;13;Barcelonès;08019;Barcelona;4;52;;1605;582;900;1197;408;1;7;1189;1196
8;Barcelona;1;Barcelona;13;Barcelonès;08019;Barcelona;4;53;;1062;330;484;684;378;1;1;682;683
8;Barcelona;1;Barcelona;13;Barcelonès;08019;Barcelona;4;54;;745;262;431;561;184;2;1;558;559
8;Barcelona;1;Barcelona;13;Barcelonès;08019;Barcelona;4;55;;1030;298;532;728;302;0;2;726;728
8;Barcelona;1;Barcelona;13;Barcelonès;08019;Barcelona;4;56;;1131;326;544;740;391;1;2;737;739
8;Barcelona;1;Barcelona;13;Barcelonès;08019;Barcelona;4;6;;894;314;480;631;263;1;1;629;630
8;Barcelona;1;Barcelona;13;Barcelonès;08019;Barcelona;4;7;;817;282;413;521;296;1;4;516;520
8;Barcelona;1;Barcelona;13;Barcelonès;08019;Barcelona;4;8;;745;265;399;518;227;1;2;515;517
8;Barcelona;1;Barcelona;13;Barcelonès;08019;Barcelona;4;84;;1053;399;631;789;264;2;4;783;787
8;Barcelona;1;Barcelona;13;Barcelonès;08019;Barcelona;4;9;;1095;382;580;746;349;0;5;741;746
8;Barcelona;1;Barcelona;13;Barcelonès;08019;Barcelona;5;1;;1206;378;512;752;454;4;3;745;748
8;Barcelona;1;Barcelona;13;Barcelonès;08019;Barcelona;5;10;;1127;449;676;871;256;1;3;867;870
8;Barcelona;1;Barcelona;13;Barcelonès;08019;Barcelona;5;11;;1009;332;550;757;252;4;1;752;753
8;Barcelona;1;Barcelona;13;Barcelonès;08019;Barcelona;5;12;;992;322;541;742;250;2;4;736;740
8;Barcelona;1;Barcelona;13;Barcelonès;08019;Barcelona;5;13;;1211;441;654;919;292;1;2;916;918
8;Barcelona;1;Barcelona;13;Barcelonès;08019;Barcelona;5;14;;1137;426;649;874;263;0;2;872;874
8;Barcelona;1;Barcelona;13;Barcelonès;08019;Barcelona;5;15;;1080;388;574;813;267;2;6;805;811
8;Barcelona;1;Barcelona;13;Barcelonès;08019;Barcelona;5;16;;1276;442;653;869;407;0;6;863;869
8;Barcelona;1;Barcelona;13;Barcelonès;08019;Barcelona;5;17;;1142;390;616;833;309;0;4;829;833
8;Barcelona;1;Barcelona;13;Barcelonès;08019;Barcelona;5;18;;911;340;515;659;252;0;1;658;659
8;Barcelona;1;Barcelona;13;Barcelonès;08019;Barcelona;5;19;;1240;459;701;980;260;0;3;977;980
8;Barcelona;1;Barcelona;13;Barcelonès;08019;Barcelona;5;2;;1108;376;609;813;295;0;0;813;813
8;Barcelona;1;Barcelona;13;Barcelonès;08019;Barcelona;5;20;;859;320;457;614;245;0;0;614;614
8;Barcelona;1;Barcelona;13;Barcelonès;08019;Barcelona;5;21;;872;308;460;622;250;0;3;619;622
8;Barcelona;1;Barcelona;13;Barcelonès;08019;Barcelona;5;22;;1336;453;729;965;371;0;7;958;965
8;Barcelona;1;Barcelona;13;Barcelonès;08019;Barcelona;5;23;;1078;410;545;778;300;1;0;777;777
8;Barcelona;1;Barcelona;13;Barcelonès;08019;Barcelona;5;24;;1437;497;694;1099;338;2;5;1092;1097
8;Barcelona;1;Barcelona;13;Barcelonès;08019;Barcelona;5;25;;977;310;539;734;243;0;3;731;734
8;Barcelona;1;Barcelona;13;Barcelonès;08019;Barcelona;5;26;;1071;361;572;794;277;0;3;791;794
8;Barcelona;1;Barcelona;13;Barcelonès;08019;Barcelona;5;27;;1038;347;560;801;237;1;3;797;800
8;Barcelona;1;Barcelona;13;Barcelonès;08019;Barcelona;5;28;;1164;370;575;822;342;1;1;820;821
8;Barcelona;1;Barcelona;13;Barcelonès;08019;Barcelona;5;29;;1232;386;637;930;302;1;6;923;929
8;Barcelona;1;Barcelona;13;Barcelonès;08019;Barcelona;5;3;;950;297;501;691;259;0;1;690;691
8;Barcelona;1;Barcelona;13;Barcelonès;08019;Barcelona;5;30;;1039;356;584;791;248;2;2;787;789
8;Barcelona;1;Barcelona;13;Barcelonès;08019;Barcelona;5;31;;1178;382;601;843;335;0;1;842;843
8;Barcelona;1;Barcelona;13;Barcelonès;08019;Barcelona;5;32;;1261;433;673;860;401;1;8;851;859
8;Barcelona;1;Barcelona;13;Barcelonès;08019;Barcelona;5;33;;952;277;485;688;264;1;1;686;687
8;Barcelona;1;Barcelona;13;Barcelonès;08019;Barcelona;5;34;;883;310;481;649;234;1;2;646;648
8;Barcelona;1;Barcelona;13;Barcelonès;08019;Barcelona;5;35;;866;320;479;631;235;0;5;626;631
8;Barcelona;1;Barcelona;13;Barcelonès;08019;Barcelona;5;36;;1284;485;729;981;303;4;3;974;977
8;Barcelona;1;Barcelona;13;Barcelonès;08019;Barcelona;5;37;;1026;304;498;707;319;1;3;703;706
8;Barcelona;1;Barcelona;13;Barcelonès;08019;Barcelona;5;38;;970;305;471;631;339;1;3;627;630
8;Barcelona;1;Barcelona;13;Barcelonès;08019;Barcelona;5;39;;1148;475;663;877;271;2;2;873;875
8;Barcelona;1;Barcelona;13;Barcelonès;08019;Barcelona;5;4;;815;255;385;523;292;1;1;521;522
8;Barcelona;1;Barcelona;13;Barcelonès;08019;Barcelona;5;40;;1020;336;557;729;291;0;3;726;729
8;Barcelona;1;Barcelona;13;Barcelonès;08019;Barcelona;5;41;;1270;378;565;789;481;0;1;788;789
8;Barcelona;1;Barcelona;13;Barcelonès;08019;Barcelona;5;42;;956;322;526;680;276;0;4;676;680
8;Barcelona;1;Barcelona;13;Barcelonès;08019;Barcelona;5;43;;1037;376;569;752;285;1;9;742;751
8;Barcelona;1;Barcelona;13;Barcelonès;08019;Barcelona;5;44;;945;297;481;645;300;0;0;645;645
8;Barcelona;1;Barcelona;13;Barcelonès;08019;Barcelona;5;45;;1165;410;634;869;296;1;3;865;868
8;Barcelona;1;Barcelona;13;Barcelonès;08019;Barcelona;5;46;;900;330;524;679;221;0;1;678;679
8;Barcelona;1;Barcelona;13;Barcelonès;08019;Barcelona;5;47;;913;313;488;681;232;1;8;672;680
8;Barcelona;1;Barcelona;13;Barcelonès;08019;Barcelona;5;48;;986;331;531;721;265;1;6;714;720
8;Barcelona;1;Barcelona;13;Barcelonès;08019;Barcelona;5;49;;1244;376;646;887;357;2;3;882;885
8;Barcelona;1;Barcelona;13;Barcelonès;08019;Barcelona;5;5;;759;232;348;459;300;1;4;454;458
8;Barcelona;1;Barcelona;13;Barcelonès;08019;Barcelona;5;50;;1213;442;638;861;352;0;5;856;861
8;Barcelona;1;Barcelona;13;Barcelonès;08019;Barcelona;5;51;;1180;457;659;911;269;2;5;904;909
8;Barcelona;1;Barcelona;13;Barcelonès;08019;Barcelona;5;52;;1125;410;624;857;268;0;2;855;857
8;Barcelona;1;Barcelona;13;Barcelonès;08019;Barcelona;5;53;;1117;373;600;836;281;1;2;833;835
8;Barcelona;1;Barcelona;13;Barcelonès;08019;Barcelona;5;54;;782;200;385;547;235;2;0;545;545
8;Barcelona;1;Barcelona;13;Barcelonès;08019;Barcelona;5;55;;1080;364;576;789;291;4;1;784;785
8;Barcelona;1;Barcelona;13;Barcelonès;08019;Barcelona;5;56;;899;307;470;633;266;0;0;633;633
8;Barcelona;1;Barcelona;13;Barcelonès;08019;Barcelona;5;57;;1303;438;727;975;328;1;3;971;974
8;Barcelona;1;Barcelona;13;Barcelonès;08019;Barcelona;5;58;;1104;364;565;748;356;2;3;743;746
8;Barcelona;1;Barcelona;13;Barcelonès;08019;Barcelona;5;59;;1160;413;633;794;366;1;0;793;793
8;Barcelona;1;Barcelona;13;Barcelonès;08019;Barcelona;5;6;;1229;419;687;914;315;1;6;907;913
8;Barcelona;1;Barcelona;13;Barcelonès;08019;Barcelona;5;60;;826;284;486;597;229;1;3;593;596
8;Barcelona;1;Barcelona;13;Barcelonès;08019;Barcelona;5;61;;1066;386;546;694;372;1;2;691;693
8;Barcelona;1;Barcelona;13;Barcelonès;08019;Barcelona;5;62;;1165;443;649;835;330;1;2;832;834
8;Barcelona;1;Barcelona;13;Barcelonès;08019;Barcelona;5;63;;1187;428;666;882;305;2;6;874;880
8;Barcelona;1;Barcelona;13;Barcelonès;08019;Barcelona;5;64;;1163;431;636;811;352;3;3;805;808
8;Barcelona;1;Barcelona;13;Barcelonès;08019;Barcelona;5;65;;1194;436;654;859;335;0;2;857;859
8;Barcelona;1;Barcelona;13;Barcelonès;08019;Barcelona;5;66;;963;338;525;716;247;3;5;708;713
8;Barcelona;1;Barcelona;13;Barcelonès;08019;Barcelona;5;67;;922;314;366;665;257;2;4;659;663
8;Barcelona;1;Barcelona;13;Barcelonès;08019;Barcelona;5;68;;1066;356;557;793;273;0;1;792;793
8;Barcelona;1;Barcelona;13;Barcelonès;08019;Barcelona;5;69;;1251;471;729;929;322;4;5;920;925
8;Barcelona;1;Barcelona;13;Barcelonès;08019;Barcelona;5;7;;1200;460;643;823;377;1;0;822;822
8;Barcelona;1;Barcelona;13;Barcelonès;08019;Barcelona;5;70;;1062;384;607;792;270;1;3;788;791
8;Barcelona;1;Barcelona;13;Barcelonès;08019;Barcelona;5;71;;1163;482;643;808;355;0;11;797;808
8;Barcelona;1;Barcelona;13;Barcelonès;08019;Barcelona;5;72;;1281;487;734;952;329;0;7;945;952
8;Barcelona;1;Barcelona;13;Barcelonès;08019;Barcelona;5;73;;1193;443;683;880;313;1;4;875;879
8;Barcelona;1;Barcelona;13;Barcelonès;08019;Barcelona;5;74;;1236;460;674;915;321;0;3;912;915
8;Barcelona;1;Barcelona;13;Barcelonès;08019;Barcelona;5;75;;1323;500;738;1011;312;3;3;1005;1008
8;Barcelona;1;Barcelona;13;Barcelonès;08019;Barcelona;5;76;;1024;321;543;756;268;2;2;752;754
8;Barcelona;1;Barcelona;13;Barcelonès;08019;Barcelona;5;77;;1096;374;580;797;299;1;5;791;796
8;Barcelona;1;Barcelona;13;Barcelonès;08019;Barcelona;5;78;;1529;513;789;1090;439;2;6;1082;1088
8;Barcelona;1;Barcelona;13;Barcelonès;08019;Barcelona;5;79;;936;333;524;702;234;0;0;702;702
8;Barcelona;1;Barcelona;13;Barcelonès;08019;Barcelona;5;8;;1175;389;612;800;375;1;4;795;799
8;Barcelona;1;Barcelona;13;Barcelonès;08019;Barcelona;5;80;;1015;398;595;763;252;0;5;758;763
8;Barcelona;1;Barcelona;13;Barcelonès;08019;Barcelona;5;81;;1099;405;630;805;294;0;2;803;805
8;Barcelona;1;Barcelona;13;Barcelonès;08019;Barcelona;5;82;;1183;481;702;901;282;1;2;898;900
8;Barcelona;1;Barcelona;13;Barcelonès;08019;Barcelona;5;83;;957;348;539;703;254;3;1;699;700
8;Barcelona;1;Barcelona;13;Barcelonès;08019;Barcelona;5;84;;970;384;561;721;249;0;3;718;721
8;Barcelona;1;Barcelona;13;Barcelonès;08019;Barcelona;5;85;;933;308;493;654;279;0;2;652;654
8;Barcelona;1;Barcelona;13;Barcelonès;08019;Barcelona;5;86;;924;328;482;660;264;2;3;655;658
8;Barcelona;1;Barcelona;13;Barcelonès;08019;Barcelona;5;87;;1154;399;615;835;319;0;1;834;835
8;Barcelona;1;Barcelona;13;Barcelonès;08019;Barcelona;5;88;;1297;509;710;946;351;6;4;936;940
8;Barcelona;1;Barcelona;13;Barcelonès;08019;Barcelona;5;89;;1291;544;735;944;347;3;0;941;941
8;Barcelona;1;Barcelona;13;Barcelonès;08019;Barcelona;5;9;;1221;449;667;905;316;1;3;901;904
8;Barcelona;1;Barcelona;13;Barcelonès;08019;Barcelona;5;90;;1336;459;693;934;402;0;5;929;934
8;Barcelona;1;Barcelona;13;Barcelonès;08019;Barcelona;5;91;;1153;427;625;854;299;1;2;851;853
8;Barcelona;1;Barcelona;13;Barcelonès;08019;Barcelona;5;92;;1194;433;624;850;344;0;4;846;850
8;Barcelona;1;Barcelona;13;Barcelonès;08019;Barcelona;5;93;;838;291;456;622;216;0;2;620;622
8;Barcelona;1;Barcelona;13;Barcelonès;08019;Barcelona;5;94;;1944;707;1073;1417;527;0;4;1413;1417
8;Barcelona;1;Barcelona;13;Barcelonès;08019;Barcelona;5;95;;1173;452;708;818;355;1;5;812;817
8;Barcelona;1;Barcelona;13;Barcelonès;08019;Barcelona;5;96;;820;279;420;572;248;0;3;569;572
8;Barcelona;1;Barcelona;13;Barcelonès;08019;Barcelona;5;97;;1143;413;626;852;291;0;4;848;852
8;Barcelona;1;Barcelona;13;Barcelonès;08019;Barcelona;5;98;;1106;319;555;771;335;2;4;765;769
8;Barcelona;1;Barcelona;13;Barcelonès;08019;Barcelona;6;1;;790;263;415;534;256;0;1;533;534
8;Barcelona;1;Barcelona;13;Barcelonès;08019;Barcelona;6;10;;789;299;462;590;199;0;3;587;590
8;Barcelona;1;Barcelona;13;Barcelonès;08019;Barcelona;6;11;;1008;330;497;685;323;0;3;682;685
8;Barcelona;1;Barcelona;13;Barcelonès;08019;Barcelona;6;12;;842;326;491;627;215;0;5;622;627
8;Barcelona;1;Barcelona;13;Barcelonès;08019;Barcelona;6;13;;1258;421;644;845;413;0;0;845;845
8;Barcelona;1;Barcelona;13;Barcelonès;08019;Barcelona;6;14;;1072;375;552;694;378;0;2;692;694
8;Barcelona;1;Barcelona;13;Barcelonès;08019;Barcelona;6;15;;1030;281;467;608;422;2;1;605;606
8;Barcelona;1;Barcelona;13;Barcelonès;08019;Barcelona;6;16;;1110;383;565;715;395;0;4;711;715
8;Barcelona;1;Barcelona;13;Barcelonès;08019;Barcelona;6;17;;999;334;505;649;350;2;2;645;647
8;Barcelona;1;Barcelona;13;Barcelonès;08019;Barcelona;6;18;;934;333;476;630;304;3;1;626;627
8;Barcelona;1;Barcelona;13;Barcelonès;08019;Barcelona;6;19;;1100;353;579;727;373;0;3;724;727
8;Barcelona;1;Barcelona;13;Barcelonès;08019;Barcelona;6;2;;1042;382;580;755;287;1;6;748;754
8;Barcelona;1;Barcelona;13;Barcelonès;08019;Barcelona;6;20;;822;313;463;570;252;0;1;569;570
8;Barcelona;1;Barcelona;13;Barcelonès;08019;Barcelona;6;21;;993;376;559;722;271;0;2;720;722
8;Barcelona;1;Barcelona;13;Barcelonès;08019;Barcelona;6;22;;954;308;486;594;360;1;0;593;593
8;Barcelona;1;Barcelona;13;Barcelonès;08019;Barcelona;6;23;;1100;416;646;829;271;0;2;827;829
8;Barcelona;1;Barcelona;13;Barcelonès;08019;Barcelona;6;24;;1251;483;689;889;362;3;1;885;886
8;Barcelona;1;Barcelona;13;Barcelonès;08019;Barcelona;6;25;;1105;406;613;804;301;1;2;801;803
8;Barcelona;1;Barcelona;13;Barcelonès;08019;Barcelona;6;26;;768;298;413;510;258;1;1;508;509
8;Barcelona;1;Barcelona;13;Barcelonès;08019;Barcelona;6;27;;892;347;506;648;244;0;0;648;648
8;Barcelona;1;Barcelona;13;Barcelonès;08019;Barcelona;6;28;;943;372;546;590;353;6;3;581;584
8;Barcelona;1;Barcelona;13;Barcelonès;08019;Barcelona;6;29;;950;338;426;668;282;5;2;661;663
8;Barcelona;1;Barcelona;13;Barcelonès;08019;Barcelona;6;3;;1634;552;822;1104;530;3;0;1101;1101
8;Barcelona;1;Barcelona;13;Barcelonès;08019;Barcelona;6;30;;951;349;509;668;283;0;2;666;668
8;Barcelona;1;Barcelona;13;Barcelonès;08019;Barcelona;6;31;;813;314;482;593;220;1;1;591;592
8;Barcelona;1;Barcelona;13;Barcelonès;08019;Barcelona;6;32;;856;321;497;610;246;1;3;606;609
8;Barcelona;1;Barcelona;13;Barcelonès;08019;Barcelona;6;33;;989;404;589;701;288;0;4;697;701
8;Barcelona;1;Barcelona;13;Barcelonès;08019;Barcelona;6;34;;940;349;561;666;274;1;1;664;665
8;Barcelona;1;Barcelona;13;Barcelonès;08019;Barcelona;6;35;;793;272;384;593;200;0;5;588;593
8;Barcelona;1;Barcelona;13;Barcelonès;08019;Barcelona;6;36;;1083;387;610;795;288;2;5;788;793
8;Barcelona;1;Barcelona;13;Barcelonès;08019;Barcelona;6;37;;776;279;418;555;221;1;1;553;554
8;Barcelona;1;Barcelona;13;Barcelonès;08019;Barcelona;6;38;;1039;381;590;759;280;0;2;757;759
8;Barcelona;1;Barcelona;13;Barcelonès;08019;Barcelona;6;39;;1084;334;542;735;349;1;2;732;734
8;Barcelona;1;Barcelona;13;Barcelonès;08019;Barcelona;6;4;;1061;382;580;758;303;1;3;754;757
8;Barcelona;1;Barcelona;13;Barcelonès;08019;Barcelona;6;40;;1156;443;644;822;334;1;5;816;821
8;Barcelona;1;Barcelona;13;Barcelonès;08019;Barcelona;6;41;;1243;457;657;897;346;2;4;891;895
8;Barcelona;1;Barcelona;13;Barcelonès;08019;Barcelona;6;42;;1155;441;653;845;310;1;3;841;844
8;Barcelona;1;Barcelona;13;Barcelonès;08019;Barcelona;6;43;;813;284;471;605;208;0;3;602;605
8;Barcelona;1;Barcelona;13;Barcelonès;08019;Barcelona;6;44;;1028;373;601;733;295;0;2;731;733
8;Barcelona;1;Barcelona;13;Barcelonès;08019;Barcelona;6;45;;846;330;464;587;259;1;1;585;586
8;Barcelona;1;Barcelona;13;Barcelonès;08019;Barcelona;6;46;;780;256;381;506;274;0;2;504;506
8;Barcelona;1;Barcelona;13;Barcelonès;08019;Barcelona;6;47;;830;273;414;535;295;0;2;533;535
8;Barcelona;1;Barcelona;13;Barcelonès;08019;Barcelona;6;48;;883;290;434;558;325;1;1;556;557
8;Barcelona;1;Barcelona;13;Barcelonès;08019;Barcelona;6;49;;771;317;454;544;227;0;3;541;544
8;Barcelona;1;Barcelona;13;Barcelonès;08019;Barcelona;6;50;;836;280;410;542;294;1;3;538;541
8;Barcelona;1;Barcelona;13;Barcelonès;08019;Barcelona;6;51;;843;337;472;602;241;0;2;600;602
8;Barcelona;1;Barcelona;13;Barcelonès;08019;Barcelona;6;52;;1055;429;621;788;267;1;0;787;787
8;Barcelona;1;Barcelona;13;Barcelonès;08019;Barcelona;6;53;;1026;345;522;722;304;0;1;721;722
8;Barcelona;1;Barcelona;13;Barcelonès;08019;Barcelona;6;54;;1051;401;562;743;308;2;0;741;741
8;Barcelona;1;Barcelona;13;Barcelonès;08019;Barcelona;6;55;;1051;391;554;683;368;1;0;682;682
8;Barcelona;1;Barcelona;13;Barcelonès;08019;Barcelona;6;56;;1035;378;539;710;325;1;1;708;709
8;Barcelona;1;Barcelona;13;Barcelonès;08019;Barcelona;6;57;;1035;360;497;675;360;2;4;669;673
8;Barcelona;1;Barcelona;13;Barcelonès;08019;Barcelona;6;58;;1157;406;680;808;349;0;3;805;808
8;Barcelona;1;Barcelona;13;Barcelonès;08019;Barcelona;6;59;;1115;375;615;793;322;2;4;787;791
8;Barcelona;1;Barcelona;13;Barcelonès;08019;Barcelona;6;6;;773;294;423;567;206;0;2;565;567
8;Barcelona;1;Barcelona;13;Barcelonès;08019;Barcelona;6;60;;1245;485;706;906;339;3;0;903;903
8;Barcelona;1;Barcelona;13;Barcelonès;08019;Barcelona;6;61;;963;313;535;688;275;1;4;683;687
8;Barcelona;1;Barcelona;13;Barcelonès;08019;Barcelona;6;62;;900;300;502;654;246;0;2;652;654
8;Barcelona;1;Barcelona;13;Barcelonès;08019;Barcelona;6;63;;1037;323;548;724;313;0;2;722;724
8;Barcelona;1;Barcelona;13;Barcelonès;08019;Barcelona;6;64;;1395;557;787;1033;362;3;0;1030;1030
8;Barcelona;1;Barcelona;13;Barcelonès;08019;Barcelona;6;65;;872;386;537;671;201;2;1;668;669
8;Barcelona;1;Barcelona;13;Barcelonès;08019;Barcelona;6;66;;724;314;404;497;227;3;1;493;494
8;Barcelona;1;Barcelona;13;Barcelonès;08019;Barcelona;6;67;;1274;464;669;888;386;2;2;884;886
8;Barcelona;1;Barcelona;13;Barcelonès;08019;Barcelona;6;68;;1145;382;614;808;337;2;1;805;806
8;Barcelona;1;Barcelona;13;Barcelonès;08019;Barcelona;6;69;;774;268;413;564;210;1;0;563;563
8;Barcelona;1;Barcelona;13;Barcelonès;08019;Barcelona;6;7;;1415;494;750;989;426;1;4;984;988
8;Barcelona;1;Barcelona;13;Barcelonès;08019;Barcelona;6;70;;1312;558;786;936;376;1;6;929;935
8;Barcelona;1;Barcelona;13;Barcelonès;08019;Barcelona;6;71;;809;325;470;601;208;0;2;599;601
8;Barcelona;1;Barcelona;13;Barcelonès;08019;Barcelona;6;72;;1225;491;722;913;312;2;3;908;911
8;Barcelona;1;Barcelona;13;Barcelonès;08019;Barcelona;6;73;;1070;428;616;787;283;0;0;787;787
8;Barcelona;1;Barcelona;13;Barcelonès;08019;Barcelona;6;74;;789;294;422;553;236;0;0;553;553
8;Barcelona;1;Barcelona;13;Barcelonès;08019;Barcelona;6;75;;858;374;538;679;179;2;1;676;677
8;Barcelona;1;Barcelona;13;Barcelonès;08019;Barcelona;6;76;;993;412;628;786;207;1;1;784;785
8;Barcelona;1;Barcelona;13;Barcelonès;08019;Barcelona;6;77;;845;288;450;583;262;0;2;581;583
8;Barcelona;1;Barcelona;13;Barcelonès;08019;Barcelona;6;78;;917;358;516;683;234;2;2;679;681
8;Barcelona;1;Barcelona;13;Barcelonès;08019;Barcelona;6;79;;826;340;483;605;221;1;1;603;604
8;Barcelona;1;Barcelona;13;Barcelonès;08019;Barcelona;6;8;;1426;530;766;966;460;2;4;960;964
8;Barcelona;1;Barcelona;13;Barcelonès;08019;Barcelona;6;80;;895;348;511;666;229;2;1;663;664
8;Barcelona;1;Barcelona;13;Barcelonès;08019;Barcelona;6;81;;960;366;558;705;255;0;3;702;705
8;Barcelona;1;Barcelona;13;Barcelonès;08019;Barcelona;6;82;;1616;571;849;1082;534;1;1;1080;1081
8;Barcelona;1;Barcelona;13;Barcelonès;08019;Barcelona;6;83;;1340;563;786;1007;333;1;3;1003;1006
8;Barcelona;1;Barcelona;13;Barcelonès;08019;Barcelona;6;84;;1131;403;650;834;297;0;3;831;834
8;Barcelona;1;Barcelona;13;Barcelonès;08019;Barcelona;6;85;;968;426;595;751;217;1;1;749;750
8;Barcelona;1;Barcelona;13;Barcelonès;08019;Barcelona;6;86;;791;281;443;626;165;1;1;624;625
8;Barcelona;1;Barcelona;13;Barcelonès;08019;Barcelona;6;87;;1512;625;924;1192;320;2;2;1188;1190
8;Barcelona;1;Barcelona;13;Barcelonès;08019;Barcelona;6;88;;967;385;581;735;232;0;1;734;735
8;Barcelona;1;Barcelona;13;Barcelonès;08019;Barcelona;6;9;;869;284;440;605;264;0;2;603;605
8;Barcelona;1;Barcelona;13;Barcelonès;08019;Barcelona;7;1;;1263;528;735;863;400;2;1;860;861
8;Barcelona;1;Barcelona;13;Barcelonès;08019;Barcelona;7;10;;960;309;471;642;318;1;2;639;641
8;Barcelona;1;Barcelona;13;Barcelonès;08019;Barcelona;7;100;;948;335;500;633;315;1;5;627;632
8;Barcelona;1;Barcelona;13;Barcelonès;08019;Barcelona;7;101;;1096;377;593;716;380;0;0;716;716
8;Barcelona;1;Barcelona;13;Barcelonès;08019;Barcelona;7;102;;484;173;236;297;187;1;1;295;296
8;Barcelona;1;Barcelona;13;Barcelonès;08019;Barcelona;7;103;;1015;350;490;601;414;1;4;596;600
8;Barcelona;1;Barcelona;13;Barcelonès;08019;Barcelona;7;104;;1186;444;593;731;455;0;7;724;731
8;Barcelona;1;Barcelona;13;Barcelonès;08019;Barcelona;7;105;;865;349;500;644;221;1;1;642;643
8;Barcelona;1;Barcelona;13;Barcelonès;08019;Barcelona;7;106;;927;327;481;611;316;1;5;605;610
8;Barcelona;1;Barcelona;13;Barcelonès;08019;Barcelona;7;107;;970;336;515;691;279;0;2;689;691
8;Barcelona;1;Barcelona;13;Barcelonès;08019;Barcelona;7;108;;994;354;513;684;310;2;1;681;682
8;Barcelona;1;Barcelona;13;Barcelonès;08019;Barcelona;7;109;;1255;477;661;802;453;1;5;796;801
8;Barcelona;1;Barcelona;13;Barcelonès;08019;Barcelona;7;11;;805;271;405;518;287;2;3;513;516
8;Barcelona;1;Barcelona;13;Barcelonès;08019;Barcelona;7;110;;843;332;449;546;297;6;3;537;540
8;Barcelona;1;Barcelona;13;Barcelonès;08019;Barcelona;7;111;;746;326;435;550;196;2;2;546;548
8;Barcelona;1;Barcelona;13;Barcelonès;08019;Barcelona;7;112;;985;379;550;688;297;2;1;685;686
8;Barcelona;1;Barcelona;13;Barcelonès;08019;Barcelona;7;113;;886;320;456;558;328;1;3;554;557
8;Barcelona;1;Barcelona;13;Barcelonès;08019;Barcelona;7;114;;947;368;542;680;267;2;4;674;678
8;Barcelona;1;Barcelona;13;Barcelonès;08019;Barcelona;7;115;;871;319;493;643;228;3;4;636;640
8;Barcelona;1;Barcelona;13;Barcelonès;08019;Barcelona;7;116;;1124;317;588;791;333;3;5;783;788
8;Barcelona;1;Barcelona;13;Barcelonès;08019;Barcelona;7;117;;1038;320;459;584;454;2;3;579;582
8;Barcelona;1;Barcelona;13;Barcelonès;08019;Barcelona;7;118;;949;388;549;661;288;5;0;656;656
8;Barcelona;1;Barcelona;13;Barcelonès;08019;Barcelona;7;119;;887;366;456;562;325;0;4;558;562
8;Barcelona;1;Barcelona;13;Barcelonès;08019;Barcelona;7;12;;1143;412;622;792;351;2;4;786;790
8;Barcelona;1;Barcelona;13;Barcelonès;08019;Barcelona;7;120;;940;317;442;551;389;1;3;547;550
8;Barcelona;1;Barcelona;13;Barcelonès;08019;Barcelona;7;121;;852;408;574;531;321;0;4;527;531
8;Barcelona;1;Barcelona;13;Barcelonès;08019;Barcelona;7;122;;1023;355;536;671;352;0;4;667;671
8;Barcelona;1;Barcelona;13;Barcelonès;08019;Barcelona;7;123;;1076;335;569;719;357;0;4;715;719
8;Barcelona;1;Barcelona;13;Barcelonès;08019;Barcelona;7;13;;995;360;617;732;263;2;0;730;730
8;Barcelona;1;Barcelona;13;Barcelonès;08019;Barcelona;7;14;;643;219;327;416;227;1;2;413;415
8;Barcelona;1;Barcelona;13;Barcelonès;08019;Barcelona;7;15;;1057;375;556;695;362;0;1;694;695
8;Barcelona;1;Barcelona;13;Barcelonès;08019;Barcelona;7;16;;1032;397;590;766;266;0;3;763;766
8;Barcelona;1;Barcelona;13;Barcelonès;08019;Barcelona;7;17;;1231;459;662;862;369;1;1;860;861
8;Barcelona;1;Barcelona;13;Barcelonès;08019;Barcelona;7;18;;1218;328;576;778;440;0;1;777;778
8;Barcelona;1;Barcelona;13;Barcelonès;08019;Barcelona;7;19;;1094;395;587;765;329;3;1;761;762
8;Barcelona;1;Barcelona;13;Barcelonès;08019;Barcelona;7;2;;918;338;503;630;288;1;3;626;629
8;Barcelona;1;Barcelona;13;Barcelonès;08019;Barcelona;7;20;;1171;403;611;781;390;1;2;778;780
8;Barcelona;1;Barcelona;13;Barcelonès;08019;Barcelona;7;21;;812;288;423;566;246;0;1;565;566
8;Barcelona;1;Barcelona;13;Barcelonès;08019;Barcelona;7;22;;874;257;399;537;337;1;0;536;536
8;Barcelona;1;Barcelona;13;Barcelonès;08019;Barcelona;7;23;;945;257;442;564;381;0;0;564;564
8;Barcelona;1;Barcelona;13;Barcelonès;08019;Barcelona;7;24;;1089;353;497;687;402;3;2;682;684
8;Barcelona;1;Barcelona;13;Barcelonès;08019;Barcelona;7;25;;1022;359;502;640;382;1;1;638;639
8;Barcelona;1;Barcelona;13;Barcelonès;08019;Barcelona;7;26;;837;325;453;548;289;2;2;544;546
8;Barcelona;1;Barcelona;13;Barcelonès;08019;Barcelona;7;27;;1442;557;784;981;461;1;2;978;980
8;Barcelona;1;Barcelona;13;Barcelonès;08019;Barcelona;7;28;;1039;339;517;656;383;1;3;652;655
8;Barcelona;1;Barcelona;13;Barcelonès;08019;Barcelona;7;29;;999;331;506;634;365;1;3;630;633
8;Barcelona;1;Barcelona;13;Barcelonès;08019;Barcelona;7;3;;929;346;522;677;252;1;1;675;676
8;Barcelona;1;Barcelona;13;Barcelonès;08019;Barcelona;7;30;;983;299;444;580;403;0;0;580;580
8;Barcelona;1;Barcelona;13;Barcelonès;08019;Barcelona;7;31;;1102;376;490;673;429;3;2;668;670
8;Barcelona;1;Barcelona;13;Barcelonès;08019;Barcelona;7;32;;1049;377;575;686;363;0;3;683;686
8;Barcelona;1;Barcelona;13;Barcelonès;08019;Barcelona;7;33;;1081;420;670;763;318;2;5;756;761
8;Barcelona;1;Barcelona;13;Barcelonès;08019;Barcelona;7;34;;1347;510;758;989;358;1;8;980;988
8;Barcelona;1;Barcelona;13;Barcelonès;08019;Barcelona;7;35;;1327;542;729;985;342;2;6;977;983
8;Barcelona;1;Barcelona;13;Barcelonès;08019;Barcelona;7;36;;1086;387;558;718;368;2;3;713;716
8;Barcelona;1;Barcelona;13;Barcelonès;08019;Barcelona;7;37;;1081;418;577;751;330;2;5;744;749
8;Barcelona;1;Barcelona;13;Barcelonès;08019;Barcelona;7;38;;971;385;525;662;309;1;2;659;661
8;Barcelona;1;Barcelona;13;Barcelonès;08019;Barcelona;7;39;;1169;415;600;793;376;0;5;788;793
8;Barcelona;1;Barcelona;13;Barcelonès;08019;Barcelona;7;4;;1095;431;628;747;348;1;2;744;746
8;Barcelona;1;Barcelona;13;Barcelonès;08019;Barcelona;7;40;;1075;370;539;710;365;0;0;710;710
8;Barcelona;1;Barcelona;13;Barcelonès;08019;Barcelona;7;41;;945;326;464;605;340;2;3;600;603
8;Barcelona;1;Barcelona;13;Barcelonès;08019;Barcelona;7;42;;1150;390;567;751;399;1;6;744;750
8;Barcelona;1;Barcelona;13;Barcelonès;08019;Barcelona;7;43;;1011;336;526;701;310;1;1;699;700
8;Barcelona;1;Barcelona;13;Barcelonès;08019;Barcelona;7;44;;1024;397;575;716;308;0;2;714;716
8;Barcelona;1;Barcelona;13;Barcelonès;08019;Barcelona;7;45;;1149;423;620;753;396;2;7;744;751
8;Barcelona;1;Barcelona;13;Barcelonès;08019;Barcelona;7;46;;1033;329;516;650;383;0;0;650;650
8;Barcelona;1;Barcelona;13;Barcelonès;08019;Barcelona;7;47;;1075;340;506;650;425;3;2;645;647
8;Barcelona;1;Barcelona;13;Barcelonès;08019;Barcelona;7;48;;987;393;537;651;336;3;1;647;648
8;Barcelona;1;Barcelona;13;Barcelonès;08019;Barcelona;7;49;;916;365;476;611;305;1;3;607;610
8;Barcelona;1;Barcelona;13;Barcelonès;08019;Barcelona;7;5;;1099;256;537;729;370;0;14;715;729
8;Barcelona;1;Barcelona;13;Barcelonès;08019;Barcelona;7;50;;852;286;416;548;304;3;0;545;545
8;Barcelona;1;Barcelona;13;Barcelonès;08019;Barcelona;7;51;;1255;378;580;769;486;0;4;765;769
8;Barcelona;1;Barcelona;13;Barcelonès;08019;Barcelona;7;52;;978;404;587;704;274;0;4;700;704
8;Barcelona;1;Barcelona;13;Barcelonès;08019;Barcelona;7;53;;1149;419;654;832;317;5;2;825;827
8;Barcelona;1;Barcelona;13;Barcelonès;08019;Barcelona;7;54;;1198;485;713;909;289;0;8;901;909
8;Barcelona;1;Barcelona;13;Barcelonès;08019;Barcelona;7;55;;951;357;531;715;236;3;5;707;712
8;Barcelona;1;Barcelona;13;Barcelonès;08019;Barcelona;7;56;;903;297;469;607;296;0;3;604;607
8;Barcelona;1;Barcelona;13;Barcelonès;08019;Barcelona;7;57;;1132;391;588;765;367;3;2;760;762
8;Barcelona;1;Barcelona;13;Barcelonès;08019;Barcelona;7;58;;1090;424;621;766;324;2;0;764;764
8;Barcelona;1;Barcelona;13;Barcelonès;08019;Barcelona;7;59;;960;275;398;518;442;1;5;512;517
8;Barcelona;1;Barcelona;13;Barcelonès;08019;Barcelona;7;6;;761;288;455;572;189;1;3;568;571
8;Barcelona;1;Barcelona;13;Barcelonès;08019;Barcelona;7;60;;1418;431;583;744;674;0;2;742;744
8;Barcelona;1;Barcelona;13;Barcelonès;08019;Barcelona;7;61;;910;326;451;555;355;3;1;551;552
8;Barcelona;1;Barcelona;13;Barcelonès;08019;Barcelona;7;62;;927;327;482;589;338;2;0;587;587
8;Barcelona;1;Barcelona;13;Barcelonès;08019;Barcelona;7;63;;1064;341;466;558;506;1;3;554;557
8;Barcelona;1;Barcelona;13;Barcelonès;08019;Barcelona;7;64;;1223;355;489;625;598;2;4;619;623
8;Barcelona;1;Barcelona;13;Barcelonès;08019;Barcelona;7;65;;1149;340;459;572;577;0;5;567;572
8;Barcelona;1;Barcelona;13;Barcelonès;08019;Barcelona;7;66;;1245;356;504;641;604;3;4;634;638
8;Barcelona;1;Barcelona;13;Barcelonès;08019;Barcelona;7;67;;1027;355;463;568;459;6;1;561;562
8;Barcelona;1;Barcelona;13;Barcelonès;08019;Barcelona;7;68;;881;285;378;478;403;2;0;476;476
8;Barcelona;1;Barcelona;13;Barcelonès;08019;Barcelona;7;69;;1010;304;446;534;476;0;0;534;534
8;Barcelona;1;Barcelona;13;Barcelonès;08019;Barcelona;7;7;;1125;383;548;663;462;2;1;660;661
8;Barcelona;1;Barcelona;13;Barcelonès;08019;Barcelona;7;70;;1021;344;490;593;428;2;0;591;591
8;Barcelona;1;Barcelona;13;Barcelonès;08019;Barcelona;7;71;;1039;342;480;608;431;0;2;606;608
8;Barcelona;1;Barcelona;13;Barcelonès;08019;Barcelona;7;72;;1023;309;478;603;420;5;2;596;598
8;Barcelona;1;Barcelona;13;Barcelonès;08019;Barcelona;7;73;;814;286;406;491;323;4;2;485;487
8;Barcelona;1;Barcelona;13;Barcelonès;08019;Barcelona;7;74;;1229;391;554;719;510;2;3;714;717
8;Barcelona;1;Barcelona;13;Barcelonès;08019;Barcelona;7;75;;860;271;390;499;361;2;2;495;497
8;Barcelona;1;Barcelona;13;Barcelonès;08019;Barcelona;7;76;;986;317;464;579;407;2;3;574;577
8;Barcelona;1;Barcelona;13;Barcelonès;08019;Barcelona;7;77;;936;283;444;484;452;2;2;480;482
8;Barcelona;1;Barcelona;13;Barcelonès;08019;Barcelona;7;78;;989;301;444;559;430;1;3;555;558
8;Barcelona;1;Barcelona;13;Barcelonès;08019;Barcelona;7;79;;1038;350;482;581;457;5;2;574;576
8;Barcelona;1;Barcelona;13;Barcelonès;08019;Barcelona;7;8;;1178;412;628;779;399;3;1;775;776
8;Barcelona;1;Barcelona;13;Barcelonès;08019;Barcelona;7;80;;1261;412;572;718;543;2;3;713;716
8;Barcelona;1;Barcelona;13;Barcelonès;08019;Barcelona;7;81;;1532;641;755;937;595;5;3;929;932
8;Barcelona;1;Barcelona;13;Barcelonès;08019;Barcelona;7;82;;936;261;387;498;438;2;1;495;496
8;Barcelona;1;Barcelona;13;Barcelonès;08019;Barcelona;7;83;;965;312;432;537;428;3;2;532;534
8;Barcelona;1;Barcelona;13;Barcelonès;08019;Barcelona;7;84;;920;276;410;529;391;0;1;528;529
8;Barcelona;1;Barcelona;13;Barcelonès;08019;Barcelona;7;85;;945;286;449;556;389;0;4;552;556
8;Barcelona;1;Barcelona;13;Barcelonès;08019;Barcelona;7;86;;1018;310;445;578;440;0;2;576;578
8;Barcelona;1;Barcelona;13;Barcelonès;08019;Barcelona;7;87;;1191;413;552;687;504;0;0;687;687
8;Barcelona;1;Barcelona;13;Barcelonès;08019;Barcelona;7;88;;1080;330;471;629;451;2;3;624;627
8;Barcelona;1;Barcelona;13;Barcelonès;08019;Barcelona;7;89;;1040;279;431;658;382;1;3;654;657
8;Barcelona;1;Barcelona;13;Barcelonès;08019;Barcelona;7;9;;906;314;476;572;334;0;0;572;572
8;Barcelona;1;Barcelona;13;Barcelonès;08019;Barcelona;7;90;;1095;287;523;654;441;5;0;649;649
8;Barcelona;1;Barcelona;13;Barcelonès;08019;Barcelona;7;91;;887;308;448;559;328;3;0;556;556
8;Barcelona;1;Barcelona;13;Barcelonès;08019;Barcelona;7;92;;975;324;435;525;450;1;1;523;524
8;Barcelona;1;Barcelona;13;Barcelonès;08019;Barcelona;7;93;;1236;436;619;776;460;3;3;770;773
8;Barcelona;1;Barcelona;13;Barcelonès;08019;Barcelona;7;94;;939;329;440;551;388;0;0;551;551
8;Barcelona;1;Barcelona;13;Barcelonès;08019;Barcelona;7;95;;1164;358;541;735;429;0;0;735;735
8;Barcelona;1;Barcelona;13;Barcelonès;08019;Barcelona;7;96;;1050;344;525;652;398;1;0;651;651
8;Barcelona;1;Barcelona;13;Barcelonès;08019;Barcelona;7;97;;728;209;291;367;361;1;0;366;366
8;Barcelona;1;Barcelona;13;Barcelonès;08019;Barcelona;7;98;;1645;579;898;1223;422;2;3;1218;1221
8;Barcelona;1;Barcelona;13;Barcelonès;08019;Barcelona;7;99;;894;333;514;657;237;0;4;653;657
8;Barcelona;1;Barcelona;13;Barcelonès;08019;Barcelona;8;1;;995;378;543;675;320;1;1;673;674
8;Barcelona;1;Barcelona;13;Barcelonès;08019;Barcelona;8;10;;846;316;450;565;281;1;2;562;564
8;Barcelona;1;Barcelona;13;Barcelonès;08019;Barcelona;8;100;;925;320;453;561;364;1;0;560;560
8;Barcelona;1;Barcelona;13;Barcelonès;08019;Barcelona;8;101;;1305;463;647;807;498;5;8;794;802
8;Barcelona;1;Barcelona;13;Barcelonès;08019;Barcelona;8;102;;1083;288;437;546;537;0;2;544;546
8;Barcelona;1;Barcelona;13;Barcelonès;08019;Barcelona;8;103;;945;212;298;357;588;0;1;356;357
8;Barcelona;1;Barcelona;13;Barcelonès;08019;Barcelona;8;104;;866;218;308;368;498;4;2;362;364
8;Barcelona;1;Barcelona;13;Barcelonès;08019;Barcelona;8;105;;979;278;405;470;509;4;4;462;466
8;Barcelona;1;Barcelona;13;Barcelonès;08019;Barcelona;8;106;;739;217;303;357;382;1;1;355;356
8;Barcelona;1;Barcelona;13;Barcelonès;08019;Barcelona;8;107;;1375;302;437;546;829;0;2;544;546
8;Barcelona;1;Barcelona;13;Barcelonès;08019;Barcelona;8;108;;1159;283;436;534;625;2;3;529;532
8;Barcelona;1;Barcelona;13;Barcelonès;08019;Barcelona;8;109;;721;190;250;285;436;1;1;283;284
8;Barcelona;1;Barcelona;13;Barcelonès;08019;Barcelona;8;11;;906;365;536;648;258;1;3;644;647
8;Barcelona;1;Barcelona;13;Barcelonès;08019;Barcelona;8;110;;1035;247;333;391;644;0;0;391;391
8;Barcelona;1;Barcelona;13;Barcelonès;08019;Barcelona;8;111;;964;226;359;444;520;1;1;442;443
8;Barcelona;1;Barcelona;13;Barcelonès;08019;Barcelona;8;112;;936;260;385;462;474;5;2;455;457
8;Barcelona;1;Barcelona;13;Barcelonès;08019;Barcelona;8;113;;1038;287;422;513;525;5;2;506;508
8;Barcelona;1;Barcelona;13;Barcelonès;08019;Barcelona;8;114;;1167;356;457;551;616;10;4;537;541
8;Barcelona;1;Barcelona;13;Barcelonès;08019;Barcelona;8;115;;962;336;437;525;437;2;0;523;523
8;Barcelona;1;Barcelona;13;Barcelonès;08019;Barcelona;8;116;;943;225;339;428;515;4;2;422;424
8;Barcelona;1;Barcelona;13;Barcelonès;08019;Barcelona;8;12;;987;321;523;640;347;0;7;633;640
8;Barcelona;1;Barcelona;13;Barcelonès;08019;Barcelona;8;13;;871;348;490;635;236;0;1;634;635
8;Barcelona;1;Barcelona;13;Barcelonès;08019;Barcelona;8;14;;890;296;442;561;329;0;4;557;561
8;Barcelona;1;Barcelona;13;Barcelonès;08019;Barcelona;8;15;;974;371;549;602;372;0;3;599;602
8;Barcelona;1;Barcelona;13;Barcelonès;08019;Barcelona;8;16;;858;289;424;512;346;0;1;511;512
8;Barcelona;1;Barcelona;13;Barcelonès;08019;Barcelona;8;17;;1021;384;558;687;334;0;4;683;687
8;Barcelona;1;Barcelona;13;Barcelonès;08019;Barcelona;8;18;;1173;435;610;752;421;2;4;746;750
8;Barcelona;1;Barcelona;13;Barcelonès;08019;Barcelona;8;19;;1209;408;575;737;472;1;0;736;736
8;Barcelona;1;Barcelona;13;Barcelonès;08019;Barcelona;8;2;;1000;359;538;664;336;0;4;660;664
8;Barcelona;1;Barcelona;13;Barcelonès;08019;Barcelona;8;20;;991;311;492;632;359;1;4;627;631
8;Barcelona;1;Barcelona;13;Barcelonès;08019;Barcelona;8;21;;1084;371;540;686;398;1;2;683;685
8;Barcelona;1;Barcelona;13;Barcelonès;08019;Barcelona;8;215;;1062;348;518;668;394;2;5;661;666
8;Barcelona;1;Barcelona;13;Barcelonès;08019;Barcelona;8;22;;962;349;495;636;326;0;3;633;636
8;Barcelona;1;Barcelona;13;Barcelonès;08019;Barcelona;8;23;;997;318;449;587;410;3;2;582;584
8;Barcelona;1;Barcelona;13;Barcelonès;08019;Barcelona;8;24;;1025;339;511;616;409;0;3;613;616
8;Barcelona;1;Barcelona;13;Barcelonès;08019;Barcelona;8;25;;847;274;395;479;368;2;2;475;477
8;Barcelona;1;Barcelona;13;Barcelonès;08019;Barcelona;8;26;;1008;313;491;619;389;1;0;618;618
8;Barcelona;1;Barcelona;13;Barcelonès;08019;Barcelona;8;27;;1059;350;541;679;380;0;4;675;679
8;Barcelona;1;Barcelona;13;Barcelonès;08019;Barcelona;8;28;;854;306;452;543;311;2;0;541;541
8;Barcelona;1;Barcelona;13;Barcelonès;08019;Barcelona;8;29;;1126;354;491;631;495;1;2;628;630
8;Barcelona;1;Barcelona;13;Barcelonès;08019;Barcelona;8;3;;958;360;510;654;304;1;1;652;653
8;Barcelona;1;Barcelona;13;Barcelonès;08019;Barcelona;8;30;;1030;344;493;604;426;2;0;602;602
8;Barcelona;1;Barcelona;13;Barcelonès;08019;Barcelona;8;31;;995;346;485;613;382;0;0;613;613
8;Barcelona;1;Barcelona;13;Barcelonès;08019;Barcelona;8;32;;975;367;478;638;337;0;2;636;638
8;Barcelona;1;Barcelona;13;Barcelonès;08019;Barcelona;8;33;;993;314;467;563;430;2;3;558;561
8;Barcelona;1;Barcelona;13;Barcelonès;08019;Barcelona;8;34;;835;275;382;482;353;5;4;473;477
8;Barcelona;1;Barcelona;13;Barcelonès;08019;Barcelona;8;35;;1427;421;576;676;751;7;1;668;669
8;Barcelona;1;Barcelona;13;Barcelonès;08019;Barcelona;8;36;;1048;300;468;577;471;1;3;573;576
8;Barcelona;1;Barcelona;13;Barcelonès;08019;Barcelona;8;37;;1119;369;546;683;436;4;6;673;679
8;Barcelona;1;Barcelona;13;Barcelonès;08019;Barcelona;8;38;;1016;340;480;588;428;2;4;582;586
8;Barcelona;1;Barcelona;13;Barcelonès;08019;Barcelona;8;39;;1043;375;551;673;370;5;0;668;668
8;Barcelona;1;Barcelona;13;Barcelonès;08019;Barcelona;8;4;;1002;362;510;654;348;0;0;654;654
8;Barcelona;1;Barcelona;13;Barcelonès;08019;Barcelona;8;40;;1206;442;591;663;543;2;5;656;661
8;Barcelona;1;Barcelona;13;Barcelonès;08019;Barcelona;8;41;;1294;339;477;596;698;4;2;590;592
8;Barcelona;1;Barcelona;13;Barcelonès;08019;Barcelona;8;42;;973;383;552;684;289;6;3;675;678
8;Barcelona;1;Barcelona;13;Barcelonès;08019;Barcelona;8;43;;923;335;441;523;400;0;3;520;523
8;Barcelona;1;Barcelona;13;Barcelonès;08019;Barcelona;8;44;;907;275;367;456;451;2;2;452;454
8;Barcelona;1;Barcelona;13;Barcelonès;08019;Barcelona;8;45;;1092;243;458;571;521;4;3;564;567
8;Barcelona;1;Barcelona;13;Barcelonès;08019;Barcelona;8;46;;973;272;416;500;473;1;4;495;499
8;Barcelona;1;Barcelona;13;Barcelonès;08019;Barcelona;8;47;;935;245;373;452;483;3;4;445;449
8;Barcelona;1;Barcelona;13;Barcelonès;08019;Barcelona;8;48;;774;195;257;307;467;5;1;301;302
8;Barcelona;1;Barcelona;13;Barcelonès;08019;Barcelona;8;49;;951;264;385;471;480;2;1;468;469
8;Barcelona;1;Barcelona;13;Barcelonès;08019;Barcelona;8;5;;894;307;449;561;333;0;1;560;561
8;Barcelona;1;Barcelona;13;Barcelonès;08019;Barcelona;8;50;;1143;451;652;823;320;5;6;812;818
8;Barcelona;1;Barcelona;13;Barcelonès;08019;Barcelona;8;51;;1020;366;535;693;327;4;2;687;689
8;Barcelona;1;Barcelona;13;Barcelonès;08019;Barcelona;8;52;;722;292;409;479;243;1;2;476;478
8;Barcelona;1;Barcelona;13;Barcelonès;08019;Barcelona;8;53;;908;351;493;622;286;0;4;618;622
8;Barcelona;1;Barcelona;13;Barcelonès;08019;Barcelona;8;54;;1364;541;689;917;447;5;1;911;912
8;Barcelona;1;Barcelona;13;Barcelonès;08019;Barcelona;8;55;;1518;590;844;1091;427;3;6;1082;1088
8;Barcelona;1;Barcelona;13;Barcelonès;08019;Barcelona;8;56;;1151;390;687;736;415;5;1;730;731
8;Barcelona;1;Barcelona;13;Barcelonès;08019;Barcelona;8;57;;1035;356;506;618;417;0;4;614;618
8;Barcelona;1;Barcelona;13;Barcelonès;08019;Barcelona;8;58;;1260;410;582;720;540;4;1;715;716
8;Barcelona;1;Barcelona;13;Barcelonès;08019;Barcelona;8;59;;773;241;352;472;301;4;5;463;468
8;Barcelona;1;Barcelona;13;Barcelonès;08019;Barcelona;8;6;;1105;414;610;740;365;1;2;737;739
8;Barcelona;1;Barcelona;13;Barcelonès;08019;Barcelona;8;60;;962;451;633;637;325;2;1;634;635
8;Barcelona;1;Barcelona;13;Barcelonès;08019;Barcelona;8;61;;1309;476;670;797;512;2;4;791;795
8;Barcelona;1;Barcelona;13;Barcelonès;08019;Barcelona;8;62;;1002;376;671;667;335;1;4;662;666
8;Barcelona;1;Barcelona;13;Barcelonès;08019;Barcelona;8;63;;944;354;519;651;293;3;0;648;648
8;Barcelona;1;Barcelona;13;Barcelonès;08019;Barcelona;8;64;;1410;472;681;846;564;1;3;842;845
8;Barcelona;1;Barcelona;13;Barcelonès;08019;Barcelona;8;65;;1106;292;412;494;612;0;3;491;494
8;Barcelona;1;Barcelona;13;Barcelonès;08019;Barcelona;8;66;;1006;240;341;432;574;2;1;429;430
8;Barcelona;1;Barcelona;13;Barcelonès;08019;Barcelona;8;67;;1202;319;507;652;550;2;6;644;650
8;Barcelona;1;Barcelona;13;Barcelonès;08019;Barcelona;8;68;;1197;362;509;621;576;2;1;618;619
8;Barcelona;1;Barcelona;13;Barcelonès;08019;Barcelona;8;69;;980;323;454;533;447;0;1;532;533
8;Barcelona;1;Barcelona;13;Barcelonès;08019;Barcelona;8;7;;967;385;559;683;284;1;4;678;682
8;Barcelona;1;Barcelona;13;Barcelonès;08019;Barcelona;8;70;;893;248;360;435;458;1;2;432;434
8;Barcelona;1;Barcelona;13;Barcelonès;08019;Barcelona;8;71;;1143;342;475;588;555;1;1;586;587
8;Barcelona;1;Barcelona;13;Barcelonès;08019;Barcelona;8;72;;858;297;424;542;316;3;3;536;539
8;Barcelona;1;Barcelona;13;Barcelonès;08019;Barcelona;8;73;;1075;266;329;445;630;5;1;439;440
8;Barcelona;1;Barcelona;13;Barcelonès;08019;Barcelona;8;74;;895;246;344;440;455;0;4;436;440
8;Barcelona;1;Barcelona;13;Barcelonès;08019;Barcelona;8;75;;1264;467;559;699;565;0;0;699;699
8;Barcelona;1;Barcelona;13;Barcelonès;08019;Barcelona;8;76;;1164;385;620;676;488;4;6;666;672
8;Barcelona;1;Barcelona;13;Barcelonès;08019;Barcelona;8;77;;1019;249;376;462;557;2;1;459;460
8;Barcelona;1;Barcelona;13;Barcelonès;08019;Barcelona;8;78;;1038;276;408;525;513;0;4;521;525
8;Barcelona;1;Barcelona;13;Barcelonès;08019;Barcelona;8;79;;919;252;371;439;480;0;3;436;439
8;Barcelona;1;Barcelona;13;Barcelonès;08019;Barcelona;8;8;;1221;429;634;816;405;0;0;816;816
8;Barcelona;1;Barcelona;13;Barcelonès;08019;Barcelona;8;80;;1031;365;507;615;416;1;6;608;614
8;Barcelona;1;Barcelona;13;Barcelonès;08019;Barcelona;8;81;;936;276;388;493;443;0;5;488;493
8;Barcelona;1;Barcelona;13;Barcelonès;08019;Barcelona;8;82;;1102;334;497;626;476;1;7;618;625
8;Barcelona;1;Barcelona;13;Barcelonès;08019;Barcelona;8;83;;842;285;402;496;346;1;3;492;495
8;Barcelona;1;Barcelona;13;Barcelonès;08019;Barcelona;8;84;;857;328;423;522;335;2;0;520;520
8;Barcelona;1;Barcelona;13;Barcelonès;08019;Barcelona;8;85;;987;243;451;582;405;1;2;579;581
8;Barcelona;1;Barcelona;13;Barcelonès;08019;Barcelona;8;86;;1161;355;515;668;493;2;4;662;666
8;Barcelona;1;Barcelona;13;Barcelonès;08019;Barcelona;8;87;;900;336;453;543;357;3;3;537;540
8;Barcelona;1;Barcelona;13;Barcelonès;08019;Barcelona;8;88;;886;265;374;475;411;0;0;475;475
8;Barcelona;1;Barcelona;13;Barcelonès;08019;Barcelona;8;89;;833;244;344;438;395;1;1;436;437
8;Barcelona;1;Barcelona;13;Barcelonès;08019;Barcelona;8;9;;1208;461;656;805;403;0;2;803;805
8;Barcelona;1;Barcelona;13;Barcelonès;08019;Barcelona;8;90;;877;289;428;478;399;3;4;471;475
8;Barcelona;1;Barcelona;13;Barcelonès;08019;Barcelona;8;91;;913;443;467;554;359;0;1;553;554
8;Barcelona;1;Barcelona;13;Barcelonès;08019;Barcelona;8;92;;778;284;368;496;282;0;2;494;496
8;Barcelona;1;Barcelona;13;Barcelonès;08019;Barcelona;8;93;;923;329;486;587;336;0;3;584;587
8;Barcelona;1;Barcelona;13;Barcelonès;08019;Barcelona;8;94;;1166;444;618;748;418;4;1;743;744
8;Barcelona;1;Barcelona;13;Barcelonès;08019;Barcelona;8;95;;874;281;442;571;303;1;2;568;570
8;Barcelona;1;Barcelona;13;Barcelonès;08019;Barcelona;8;96;;1104;370;555;683;421;2;0;681;681
8;Barcelona;1;Barcelona;13;Barcelonès;08019;Barcelona;8;97;;984;277;409;526;458;2;0;524;524
8;Barcelona;1;Barcelona;13;Barcelonès;08019;Barcelona;8;98;;897;300;394;493;404;0;1;492;493
8;Barcelona;1;Barcelona;13;Barcelonès;08019;Barcelona;8;99;;967;376;506;533;434;2;0;531;531
8;Barcelona;1;Barcelona;13;Barcelonès;08019;Barcelona;9;1;;1286;293;435;564;722;6;2;556;558
8;Barcelona;1;Barcelona;13;Barcelonès;08019;Barcelona;9;10;;1466;576;783;926;540;4;3;919;922
8;Barcelona;1;Barcelona;13;Barcelonès;08019;Barcelona;9;11;;1255;364;516;623;632;4;2;617;619
8;Barcelona;1;Barcelona;13;Barcelonès;08019;Barcelona;9;13;;1213;326;464;573;640;4;3;566;569
8;Barcelona;1;Barcelona;13;Barcelonès;08019;Barcelona;9;14;;1285;344;484;577;708;2;1;574;575
8;Barcelona;1;Barcelona;13;Barcelonès;08019;Barcelona;9;15;;1200;390;537;665;535;1;4;660;664
8;Barcelona;1;Barcelona;13;Barcelonès;08019;Barcelona;9;156;;995;410;582;680;315;0;1;679;680
8;Barcelona;1;Barcelona;13;Barcelonès;08019;Barcelona;9;16;;1140;496;760;845;295;2;4;839;843
8;Barcelona;1;Barcelona;13;Barcelonès;08019;Barcelona;9;17;;1164;406;590;758;406;0;3;755;758
8;Barcelona;1;Barcelona;13;Barcelonès;08019;Barcelona;9;18;;1180;479;661;808;372;1;2;805;807
8;Barcelona;1;Barcelona;13;Barcelonès;08019;Barcelona;9;19;;2100;828;1182;1537;563;0;4;1533;1537
8;Barcelona;1;Barcelona;13;Barcelonès;08019;Barcelona;9;2;;1147;220;389;527;620;1;1;525;526
8;Barcelona;1;Barcelona;13;Barcelonès;08019;Barcelona;9;20;;915;384;552;702;213;1;0;701;701
8;Barcelona;1;Barcelona;13;Barcelonès;08019;Barcelona;9;21;;1126;454;648;809;317;0;7;802;809
8;Barcelona;1;Barcelona;13;Barcelonès;08019;Barcelona;9;22;;1004;456;643;774;230;0;0;774;774
8;Barcelona;1;Barcelona;13;Barcelonès;08019;Barcelona;9;23;;954;438;599;731;223;0;3;728;731
8;Barcelona;1;Barcelona;13;Barcelonès;08019;Barcelona;9;24;;912;364;533;695;217;0;4;691;695
8;Barcelona;1;Barcelona;13;Barcelonès;08019;Barcelona;9;25;;924;352;573;702;222;0;3;699;702
8;Barcelona;1;Barcelona;13;Barcelonès;08019;Barcelona;9;26;;1257;520;740;910;347;2;3;905;908
8;Barcelona;1;Barcelona;13;Barcelonès;08019;Barcelona;9;27;;1092;437;639;770;322;1;1;768;769
8;Barcelona;1;Barcelona;13;Barcelonès;08019;Barcelona;9;28;;1174;501;714;918;256;2;1;915;916
8;Barcelona;1;Barcelona;13;Barcelonès;08019;Barcelona;9;29;;921;371;527;650;271;2;4;644;648
8;Barcelona;1;Barcelona;13;Barcelonès;08019;Barcelona;9;3;;1269;362;480;580;689;4;1;575;576
8;Barcelona;1;Barcelona;13;Barcelonès;08019;Barcelona;9;30;;1122;444;622;788;334;1;4;783;787
8;Barcelona;1;Barcelona;13;Barcelonès;08019;Barcelona;9;31;;879;289;463;654;225;2;1;651;652
8;Barcelona;1;Barcelona;13;Barcelonès;08019;Barcelona;9;32;;1479;479;725;917;562;3;2;912;914
8;Barcelona;1;Barcelona;13;Barcelonès;08019;Barcelona;9;33;;2424;804;1125;1549;875;5;9;1535;1544
8;Barcelona;1;Barcelona;13;Barcelonès;08019;Barcelona;9;34;;1103;319;681;722;381;0;1;721;722
8;Barcelona;1;Barcelona;13;Barcelonès;08019;Barcelona;9;35;;1186;487;657;790;396;0;4;786;790
8;Barcelona;1;Barcelona;13;Barcelonès;08019;Barcelona;9;36;;1144;504;691;827;317;2;5;820;825
8;Barcelona;1;Barcelona;13;Barcelonès;08019;Barcelona;9;37;;1054;401;542;661;393;1;3;657;660
8;Barcelona;1;Barcelona;13;Barcelonès;08019;Barcelona;9;38;;1279;526;743;938;341;2;2;934;936
8;Barcelona;1;Barcelona;13;Barcelonès;08019;Barcelona;9;39;;1242;488;685;847;395;5;2;840;842
8;Barcelona;1;Barcelona;13;Barcelonès;08019;Barcelona;9;4;;1019;269;402;528;491;7;0;521;521
8;Barcelona;1;Barcelona;13;Barcelonès;08019;Barcelona;9;40;;1180;488;678;840;340;2;2;836;838
8;Barcelona;1;Barcelona;13;Barcelonès;08019;Barcelona;9;41;;1102;400;606;777;325;0;2;775;777
8;Barcelona;1;Barcelona;13;Barcelonès;08019;Barcelona;9;42;;989;374;564;699;290;2;2;695;697
8;Barcelona;1;Barcelona;13;Barcelonès;08019;Barcelona;9;43;;996;336;501;648;348;0;5;643;648
8;Barcelona;1;Barcelona;13;Barcelonès;08019;Barcelona;9;44;;1150;451;627;816;334;3;1;812;813
8;Barcelona;1;Barcelona;13;Barcelonès;08019;Barcelona;9;45;;1139;390;614;756;383;4;0;752;752
8;Barcelona;1;Barcelona;13;Barcelonès;08019;Barcelona;9;46;;1055;395;584;756;299;0;1;755;756
8;Barcelona;1;Barcelona;13;Barcelonès;08019;Barcelona;9;47;;1247;463;676;885;362;1;2;882;884
8;Barcelona;1;Barcelona;13;Barcelonès;08019;Barcelona;9;48;;1110;347;590;772;338;4;4;764;768
8;Barcelona;1;Barcelona;13;Barcelonès;08019;Barcelona;9;49;;971;308;486;644;327;1;4;639;643
8;Barcelona;1;Barcelona;13;Barcelonès;08019;Barcelona;9;5;;1078;335;503;658;420;0;3;655;658
8;Barcelona;1;Barcelona;13;Barcelonès;08019;Barcelona;9;50;;1225;512;712;889;336;2;3;884;887
8;Barcelona;1;Barcelona;13;Barcelonès;08019;Barcelona;9;51;;954;370;561;663;291;1;1;661;662
8;Barcelona;1;Barcelona;13;Barcelonès;08019;Barcelona;9;52;;958;416;566;703;255;0;1;702;703
8;Barcelona;1;Barcelona;13;Barcelonès;08019;Barcelona;9;53;;1228;463;718;894;334;1;1;892;893
8;Barcelona;1;Barcelona;13;Barcelonès;08019;Barcelona;9;54;;911;346;494;627;284;2;0;625;625
8;Barcelona;1;Barcelona;13;Barcelonès;08019;Barcelona;9;55;;1276;487;661;809;467;3;1;805;806
8;Barcelona;1;Barcelona;13;Barcelonès;08019;Barcelona;9;56;;947;375;532;663;284;3;0;660;660
8;Barcelona;1;Barcelona;13;Barcelonès;08019;Barcelona;9;57;;1132;402;578;740;392;1;2;737;739
8;Barcelona;1;Barcelona;13;Barcelonès;08019;Barcelona;9;58;;1064;404;579;738;326;1;3;734;737
8;Barcelona;1;Barcelona;13;Barcelonès;08019;Barcelona;9;59;;1066;417;639;740;326;0;4;736;740
8;Barcelona;1;Barcelona;13;Barcelonès;08019;Barcelona;9;6;;901;220;326;390;511;2;0;388;388
8;Barcelona;1;Barcelona;13;Barcelonès;08019;Barcelona;9;60;;1044;374;558;732;312;1;1;730;731
8;Barcelona;1;Barcelona;13;Barcelonès;08019;Barcelona;9;61;;1266;483;671;883;383;0;2;881;883
8;Barcelona;1;Barcelona;13;Barcelonès;08019;Barcelona;9;62;;833;342;467;548;285;0;1;547;548
8;Barcelona;1;Barcelona;13;Barcelonès;08019;Barcelona;9;63;;882;328;507;636;246;2;4;630;634
8;Barcelona;1;Barcelona;13;Barcelonès;08019;Barcelona;9;64;;985;417;609;723;262;0;2;721;723
8;Barcelona;1;Barcelona;13;Barcelonès;08019;Barcelona;9;65;;1537;621;883;1085;452;2;4;1079;1083
8;Barcelona;1;Barcelona;13;Barcelonès;08019;Barcelona;9;66;;1114;423;645;811;303;1;3;807;810
8;Barcelona;1;Barcelona;13;Barcelonès;08019;Barcelona;9;67;;1094;401;694;740;354;1;3;736;739
8;Barcelona;1;Barcelona;13;Barcelonès;08019;Barcelona;9;68;;1206;460;702;856;350;0;3;853;856
8;Barcelona;1;Barcelona;13;Barcelonès;08019;Barcelona;9;69;;707;279;392;480;227;2;3;475;478
8;Barcelona;1;Barcelona;13;Barcelonès;08019;Barcelona;9;7;;919;249;360;430;489;2;0;428;428
8;Barcelona;1;Barcelona;13;Barcelonès;08019;Barcelona;9;70;;1225;380;604;731;494;0;4;727;731
8;Barcelona;1;Barcelona;13;Barcelonès;08019;Barcelona;9;71;;1409;519;752;919;490;9;3;907;910
8;Barcelona;1;Barcelona;13;Barcelonès;08019;Barcelona;9;72;;1012;324;432;570;442;2;2;566;568
8;Barcelona;1;Barcelona;13;Barcelonès;08019;Barcelona;9;73;;1229;523;707;881;348;1;2;878;880
8;Barcelona;1;Barcelona;13;Barcelonès;08019;Barcelona;9;74;;1232;464;674;838;394;0;6;832;838
8;Barcelona;1;Barcelona;13;Barcelonès;08019;Barcelona;9;75;;1110;264;580;755;355;2;2;751;753
8;Barcelona;1;Barcelona;13;Barcelonès;08019;Barcelona;9;76;;1102;405;577;707;395;1;0;706;706
8;Barcelona;1;Barcelona;13;Barcelonès;08019;Barcelona;9;77;;1211;466;679;810;401;2;4;804;808
8;Barcelona;1;Barcelona;13;Barcelonès;08019;Barcelona;9;78;;1067;407;569;720;347;2;2;716;718
8;Barcelona;1;Barcelona;13;Barcelonès;08019;Barcelona;9;79;;1208;476;656;841;367;3;2;836;838
8;Barcelona;1;Barcelona;13;Barcelonès;08019;Barcelona;9;8;;1180;466;736;924;256;2;4;918;922
8;Barcelona;1;Barcelona;13;Barcelonès;08019;Barcelona;9;80;;1014;343;515;679;335;1;0;678;678
8;Barcelona;1;Barcelona;13;Barcelonès;08019;Barcelona;9;81;;1273;441;648;835;438;5;7;823;830
8;Barcelona;1;Barcelona;13;Barcelonès;08019;Barcelona;9;82;;1421;487;663;900;521;0;3;897;900
8;Barcelona;1;Barcelona;13;Barcelonès;08019;Barcelona;9;83;;1169;465;668;802;367;1;3;798;801
8;Barcelona;1;Barcelona;13;Barcelonès;08019;Barcelona;9;84;;1304;535;761;942;362;3;5;934;939
8;Barcelona;1;Barcelona;13;Barcelonès;08019;Barcelona;9;85;;1268;454;698;871;397;1;3;867;870
8;Barcelona;1;Barcelona;13;Barcelonès;08019;Barcelona;9;86;;1030;390;529;671;359;1;0;670;670
8;Barcelona;1;Barcelona;13;Barcelonès;08019;Barcelona;9;87;;1000;396;592;754;246;0;4;750;754
8;Barcelona;1;Barcelona;13;Barcelonès;08019;Barcelona;9;88;;1423;572;791;951;472;1;4;946;950
8;Barcelona;1;Barcelona;13;Barcelonès;08019;Barcelona;9;89;;1089;378;620;773;316;3;3;767;770
8;Barcelona;1;Barcelona;13;Barcelonès;08019;Barcelona;9;9;;1043;372;531;677;366;1;1;675;676
8;Barcelona;1;Barcelona;13;Barcelonès;08019;Barcelona;9;90;;1171;432;630;787;384;1;0;786;786
8;Barcelona;1;Barcelona;13;Barcelonès;08019;Barcelona;9;91;;1380;590;796;981;399;5;4;972;976
8;Barcelona;1;Barcelona;13;Barcelonès;08019;Barcelona;9;92;;1489;560;797;989;500;2;1;986;987
8;Barcelona;1;Barcelona;13;Barcelonès;08019;Barcelona;9;93;;1026;385;555;693;333;0;2;691;693
8;Barcelona;1;Barcelona;13;Barcelonès;08019;Barcelona;9;94;;1512;556;847;1052;460;0;3;1049;1052
8;Barcelona;1;Barcelona;13;Barcelonès;08019;Barcelona;9;95;;1496;581;859;1042;454;1;2;1039;1041
25;Lleida;4;Lleida;23;Noguera;25042;Baronia de Rialb, la;1;1;;208;106;144;173;35;3;0;170;170
17;Girona;3;Girona;2;Alt Empordà;17016;Bàscara;1;1;;728;349;505;579;149;17;24;538;562
25;Lleida;5;Alt Pirineu i territori d'Aran;4;Alt Urgell;25044;Bassella;1;1;;181;91;128;167;14;1;0;166;166
43;Tarragona;7;Terres de l'Ebre;37;Terra Alta;43022;Batea;1;1;;827;285;460;652;175;20;42;590;632
43;Tarragona;7;Terres de l'Ebre;37;Terra Alta;43022;Batea;1;2;;668;192;391;521;147;10;25;486;511
25;Lleida;5;Alt Pirineu i territori d'Aran;39;Consell General d'Aran;25045;Bausen;1;1;;57;28;34;49;8;0;0;49;49
8;Barcelona;1;Barcelona;11;Baix Llobregat;08020;Begues;1;1;;1845;658;989;1336;509;10;18;1308;1326
8;Barcelona;1;Barcelona;11;Baix Llobregat;08020;Begues;1;2;;1510;574;828;1093;417;4;6;1083;1089
8;Barcelona;1;Barcelona;11;Baix Llobregat;08020;Begues;1;3;;1899;660;952;1295;604;2;9;1284;1293
17;Girona;3;Girona;10;Baix Empordà;17013;Begur;1;1;;1388;548;728;907;481;16;17;874;891
17;Girona;3;Girona;10;Baix Empordà;17013;Begur;1;2;;630;240;373;444;186;3;6;435;441
17;Girona;3;Girona;10;Baix Empordà;17013;Begur;1;3;;969;437;627;748;221;16;17;715;732
25;Lleida;4;Lleida;38;Urgell;25046;Belianes;1;1;;410;157;233;303;107;24;35;244;279
25;Lleida;4;Lleida;18;Garrigues;25170;Bellaguarda;1;1;;261;112;167;231;30;2;3;226;229
17;Girona;3;Girona;10;Baix Empordà;17018;Bellcaire d'Empordà;1;1;;519;246;346;427;92;13;13;401;414
25;Lleida;4;Lleida;23;Noguera;25047;Bellcaire d'Urgell;1;1;;997;505;660;818;179;6;29;783;812
25;Lleida;4;Lleida;27;Pla d'Urgell;25048;Bell-lloc d'Urgell;1;1;;817;337;462;603;214;10;19;574;593
25;Lleida;4;Lleida;27;Pla d'Urgell;25048;Bell-lloc d'Urgell;1;2;;905;427;574;717;188;8;19;690;709
25;Lleida;4;Lleida;23;Noguera;25049;Bellmunt d'Urgell;1;1;;158;74;120;137;21;5;0;132;132
43;Tarragona;6;Camp de Tarragona;29;Priorat;43023;Bellmunt del Priorat;1;1;;218;93;121;165;53;4;23;138;161
8;Barcelona;8;Penedès;6;Anoia;08021;Bellprat;1;1;;61;24;34;46;15;0;1;45;46
25;Lleida;4;Lleida;38;Urgell;25050;Bellpuig;1;1;;1418;429;762;944;474;18;44;882;926
25;Lleida;4;Lleida;38;Urgell;25050;Bellpuig;1;2;;1084;344;608;777;307;3;32;742;774
25;Lleida;4;Lleida;38;Urgell;25050;Bellpuig;1;3;;784;273;449;564;220;7;13;544;557
43;Tarragona;8;Penedès;12;Baix Penedès;43024;Bellvei;1;1;;1557;674;912;1086;471;13;30;1043;1073
25;Lleida;5;Alt Pirineu i territori d'Aran;15;Cerdanya;25051;Bellver de Cerdanya;1;1;;1525;550;894;1086;439;18;35;1033;1068
25;Lleida;4;Lleida;27;Pla d'Urgell;25052;Bellvís;1;1;;1604;666;956;1233;371;27;28;1178;1206
25;Lleida;4;Lleida;33;Segrià;25053;Benavent de Segrià;1;1;;1104;462;663;818;286;7;13;798;811
43;Tarragona;7;Terres de l'Ebre;9;Baix Ebre;43025;Benifallet;1;1;;610;293;392;534;76;1;5;528;533
43;Tarragona;7;Terres de l'Ebre;30;Ribera d'Ebre;43026;Benissanet;1;1;;788;319;422;545;243;18;91;436;527
8;Barcelona;2;Catalunya Central;14;Berguedà;08022;Berga;1;1;;1135;366;579;735;400;6;8;721;729
8;Barcelona;2;Catalunya Central;14;Berguedà;08022;Berga;1;2;;948;375;533;640;308;4;13;623;636
8;Barcelona;2;Catalunya Central;14;Berguedà;08022;Berga;1;3;;730;337;468;588;142;2;8;578;586
8;Barcelona;2;Catalunya Central;14;Berguedà;08022;Berga;1;4;;1597;633;911;1102;495;2;13;1087;1100
8;Barcelona;2;Catalunya Central;14;Berguedà;08022;Berga;1;5;;1409;594;827;1011;398;6;11;994;1005
8;Barcelona;2;Catalunya Central;14;Berguedà;08022;Berga;1;6;;637;230;312;401;236;1;2;398;400
8;Barcelona;2;Catalunya Central;14;Berguedà;08022;Berga;2;1;;676;219;294;365;311;3;3;359;362
8;Barcelona;2;Catalunya Central;14;Berguedà;08022;Berga;2;2;;655;210;289;379;276;1;8;370;378
8;Barcelona;2;Catalunya Central;14;Berguedà;08022;Berga;2;3;;1199;440;642;795;404;2;6;787;793
8;Barcelona;2;Catalunya Central;14;Berguedà;08022;Berga;2;4;;1409;539;775;1002;407;3;11;988;999
8;Barcelona;2;Catalunya Central;14;Berguedà;08022;Berga;2;5;;818;280;371;457;361;8;3;446;449
8;Barcelona;2;Catalunya Central;14;Berguedà;08022;Berga;3;1;;450;191;254;343;107;1;6;336;342
8;Barcelona;2;Catalunya Central;14;Berguedà;08022;Berga;4;1;;607;248;326;438;169;3;5;430;435
17;Girona;3;Girona;19;Garrotxa;17019;Besalú;1;1;;1789;787;1145;1369;420;24;60;1285;1345
17;Girona;3;Girona;20;Gironès;17020;Bescanó;1;1;;1276;547;793;983;293;13;12;958;970
17;Girona;3;Girona;20;Gironès;17020;Bescanó;1;2;;862;326;472;600;262;6;20;574;594
17;Girona;3;Girona;20;Gironès;17020;Bescanó;1;3;;1546;632;974;1217;329;16;35;1166;1201
17;Girona;3;Girona;19;Garrotxa;17021;Beuda;1;1;;135;53;63;107;28;0;0;107;107
8;Barcelona;1;Barcelona;41;Vallès Oriental;08023;Bigues i Riells;1;1;;1487;542;787;973;514;10;7;956;963
8;Barcelona;1;Barcelona;41;Vallès Oriental;08023;Bigues i Riells;1;2;;1522;508;762;984;538;11;8;965;973
8;Barcelona;1;Barcelona;41;Vallès Oriental;08023;Bigues i Riells;1;3;;1718;593;826;1044;674;6;8;1030;1038
8;Barcelona;1;Barcelona;41;Vallès Oriental;08023;Bigues i Riells;1;4;;1534;539;744;908;626;14;8;886;894
8;Barcelona;1;Barcelona;41;Vallès Oriental;08023;Bigues i Riells;1;5;;719;279;403;515;204;7;15;493;508
25;Lleida;4;Lleida;32;Segarra;25055;Biosca;1;1;;165;69;108;132;33;12;6;114;120
17;Girona;3;Girona;10;Baix Empordà;17022;Bisbal d'Empordà, la;1;2;;1137;436;620;768;369;8;19;741;760
17;Girona;3;Girona;10;Baix Empordà;17022;Bisbal d'Empordà, la;1;3;;1342;474;653;832;510;3;19;810;829
17;Girona;3;Girona;10;Baix Empordà;17022;Bisbal d'Empordà, la;1;4;;1543;598;833;1046;497;20;15;1011;1026
17;Girona;3;Girona;10;Baix Empordà;17022;Bisbal d'Empordà, la;2;1;;1387;512;727;891;496;8;14;869;883
17;Girona;3;Girona;10;Baix Empordà;17022;Bisbal d'Empordà, la;2;2;;875;306;418;538;337;6;15;517;532
17;Girona;3;Girona;10;Baix Empordà;17022;Bisbal d'Empordà, la;2;3;;803;288;399;513;290;7;12;494;506
43;Tarragona;6;Camp de Tarragona;29;Priorat;43027;Bisbal de Falset, la;1;1;;166;72;97;126;40;6;1;119;120
43;Tarragona;8;Penedès;12;Baix Penedès;43028;Bisbal del Penedès, la;1;1;;1346;580;767;982;364;26;23;933;956
43;Tarragona;8;Penedès;12;Baix Penedès;43028;Bisbal del Penedès, la;1;2;;1454;471;647;803;651;12;21;770;791
17;Girona;3;Girona;2;Alt Empordà;17234;Biure;1;1;;186;95;130;152;34;11;1;140;141
43;Tarragona;6;Camp de Tarragona;16;Conca de Barberà;43029;Blancafort;1;1;;322;138;199;234;88;4;15;215;230
17;Girona;3;Girona;34;Selva;17023;Blanes;1;1;;1020;443;569;682;338;5;9;668;677
17;Girona;3;Girona;34;Selva;17023;Blanes;1;2;;1370;514;722;903;467;5;9;889;898
17;Girona;3;Girona;34;Selva;17023;Blanes;1;4;;1450;574;726;821;629;10;4;807;811
17;Girona;3;Girona;34;Selva;17023;Blanes;1;6;;1503;509;717;783;720;7;5;771;776
17;Girona;3;Girona;34;Selva;17023;Blanes;1;7;;783;312;428;539;244;4;15;520;535
17;Girona;3;Girona;34;Selva;17023;Blanes;2;1;;1643;622;839;1022;621;8;13;1001;1014
17;Girona;3;Girona;34;Selva;17023;Blanes;2;10;;1601;416;601;742;859;3;5;734;739
17;Girona;3;Girona;34;Selva;17023;Blanes;2;11;;1735;487;748;996;739;5;8;983;991
17;Girona;3;Girona;34;Selva;17023;Blanes;2;12;;711;244;337;393;318;2;7;384;391
17;Girona;3;Girona;34;Selva;17023;Blanes;2;13;;793;240;367;482;311;2;2;478;480
17;Girona;3;Girona;34;Selva;17023;Blanes;2;2;;942;324;445;550;392;3;4;543;547
17;Girona;3;Girona;34;Selva;17023;Blanes;2;3;;1321;381;537;672;649;4;4;664;668
17;Girona;3;Girona;34;Selva;17023;Blanes;2;4;;1687;584;783;969;718;5;10;954;964
17;Girona;3;Girona;34;Selva;17023;Blanes;2;5;;1798;565;830;1050;748;4;6;1040;1046
17;Girona;3;Girona;34;Selva;17023;Blanes;2;6;;1107;440;554;768;339;2;8;758;766
17;Girona;3;Girona;34;Selva;17023;Blanes;2;7;;1647;578;807;998;649;3;4;991;995
17;Girona;3;Girona;34;Selva;17023;Blanes;2;8;;874;350;478;591;283;3;4;584;588
17;Girona;3;Girona;34;Selva;17023;Blanes;2;9;;674;238;345;424;250;0;0;424;424
17;Girona;3;Girona;34;Selva;17023;Blanes;3;1;;1080;311;456;592;488;3;4;585;589
17;Girona;3;Girona;34;Selva;17023;Blanes;3;2;;855;327;406;492;363;2;2;488;490
17;Girona;3;Girona;34;Selva;17023;Blanes;3;3;;1477;430;663;862;615;3;4;855;859
17;Girona;3;Girona;34;Selva;17023;Blanes;3;4;;1593;472;689;890;703;6;7;877;884
17;Girona;3;Girona;2;Alt Empordà;17029;Boadella i les Escaules;1;1;;207;126;152;178;29;0;1;177;178
17;Girona;5;Alt Pirineu i territori d'Aran;15;Cerdanya;17024;Bolvir;1;1;;292;120;192;260;32;1;1;258;259
43;Tarragona;8;Penedès;12;Baix Penedès;43030;Bonastre;1;1;;494;200;298;350;144;1;11;338;349
25;Lleida;5;Alt Pirineu i territori d'Aran;39;Consell General d'Aran;25057;Bòrdes, es;1;1;;215;61;83;156;59;1;4;151;155
17;Girona;3;Girona;20;Gironès;17025;Bordils;1;1;;1183;521;739;879;304;24;32;823;855
25;Lleida;4;Lleida;18;Garrigues;25058;Borges Blanques, les;1;1;;678;271;347;456;222;1;11;444;455
25;Lleida;4;Lleida;18;Garrigues;25058;Borges Blanques, les;1;2;;1112;436;592;795;317;8;7;780;787
25;Lleida;4;Lleida;18;Garrigues;25058;Borges Blanques, les;2;1;;1522;597;813;1085;437;10;12;1063;1075
25;Lleida;4;Lleida;18;Garrigues;25058;Borges Blanques, les;2;2;;1072;436;549;693;379;7;6;680;686
43;Tarragona;6;Camp de Tarragona;8;Baix Camp;43031;Borges del Camp, les;1;1;;1472;661;907;1148;324;18;12;1118;1130
17;Girona;3;Girona;2;Alt Empordà;17026;Borrassà;1;1;;547;225;326;392;155;25;60;307;367
8;Barcelona;2;Catalunya Central;14;Berguedà;08024;Borredà;1;1;;376;179;257;326;50;3;8;315;323
25;Lleida;5;Alt Pirineu i territori d'Aran;39;Consell General d'Aran;25059;Bossòst;1;1;;834;356;488;633;201;14;8;611;619
43;Tarragona;7;Terres de l'Ebre;37;Terra Alta;43032;Bot;1;1;;464;230;289;390;74;3;8;379;387
43;Tarragona;6;Camp de Tarragona;8;Baix Camp;43033;Botarell;1;1;;778;355;484;585;193;9;12;564;576
25;Lleida;4;Lleida;18;Garrigues;25056;Bovera;1;1;;216;105;149;186;30;1;13;172;185
43;Tarragona;6;Camp de Tarragona;1;Alt Camp;43034;Bràfim;1;1;;473;244;299;421;52;5;4;412;416
17;Girona;3;Girona;34;Selva;17027;Breda;1;1;;1600;604;961;1165;435;25;10;1130;1140
17;Girona;3;Girona;34;Selva;17027;Breda;1;2;;1273;577;800;976;297;13;12;951;963
8;Barcelona;8;Penedès;6;Anoia;08025;Bruc, el;1;1;;1559;532;848;1053;506;16;28;1009;1037
8;Barcelona;2;Catalunya Central;24;Osona;08026;Brull, el;1;1;;194;81;105;141;53;2;28;111;139
17;Girona;3;Girona;34;Selva;17028;Brunyola i Sant Martí Sapresa;1;1;;297;164;225;261;36;2;4;255;259
43;Tarragona;6;Camp de Tarragona;29;Priorat;43035;Cabacés;1;1;;236;111;155;197;39;7;23;167;190
25;Lleida;4;Lleida;23;Noguera;25060;Cabanabona;1;1;;70;22;35;48;22;0;5;43;48
17;Girona;3;Girona;2;Alt Empordà;17031;Cabanelles;1;1;;189;56;72;94;95;3;9;82;91
17;Girona;3;Girona;2;Alt Empordà;17030;Cabanes;1;1;;661;280;415;532;129;2;14;516;530
8;Barcelona;8;Penedès;3;Alt Penedès;08027;Cabanyes, les;1;1;;717;300;451;555;162;7;19;529;548
25;Lleida;5;Alt Pirineu i territori d'Aran;4;Alt Urgell;25061;Cabó;1;1;;79;30;49;60;19;0;5;55;60
43;Tarragona;6;Camp de Tarragona;1;Alt Camp;43036;Cabra del Camp;1;1;;869;353;510;603;266;8;12;583;595
8;Barcelona;8;Penedès;6;Anoia;08028;Cabrera d'Anoia;1;1;;1090;447;606;711;379;5;9;697;706
8;Barcelona;1;Barcelona;21;Maresme;08029;Cabrera de Mar;1;1;;1872;723;1047;1386;486;3;18;1365;1383
8;Barcelona;1;Barcelona;21;Maresme;08029;Cabrera de Mar;1;2;;1720;634;935;1250;470;2;4;1244;1248
8;Barcelona;1;Barcelona;21;Maresme;08030;Cabrils;1;1;;2580;808;1260;1721;859;6;18;1697;1715
8;Barcelona;1;Barcelona;21;Maresme;08030;Cabrils;1;2;;2738;882;1355;1860;878;8;22;1830;1852
17;Girona;3;Girona;2;Alt Empordà;17032;Cadaqués;1;1;;1830;674;1051;1308;522;19;43;1246;1289
8;Barcelona;2;Catalunya Central;6;Anoia;08031;Calaf;1;1;;551;240;325;411;140;4;10;397;407
8;Barcelona;2;Catalunya Central;6;Anoia;08031;Calaf;1;2;;1810;733;1053;1342;468;19;39;1284;1323
43;Tarragona;8;Penedès;12;Baix Penedès;43037;Calafell;1;1;;1974;729;1096;1358;616;8;7;1343;1350
43;Tarragona;8;Penedès;12;Baix Penedès;43037;Calafell;1;2;;1981;660;914;1149;832;2;3;1144;1147
43;Tarragona;8;Penedès;12;Baix Penedès;43037;Calafell;1;3;;1408;504;683;897;511;3;7;887;894
43;Tarragona;8;Penedès;12;Baix Penedès;43037;Calafell;2;1;;1692;627;870;1087;605;6;6;1075;1081
43;Tarragona;8;Penedès;12;Baix Penedès;43037;Calafell;2;2;;1682;548;763;972;710;2;5;965;970
43;Tarragona;8;Penedès;12;Baix Penedès;43037;Calafell;2;3;;864;235;373;465;399;2;3;460;463
43;Tarragona;8;Penedès;12;Baix Penedès;43037;Calafell;3;1;;1822;544;765;989;833;4;7;978;985
43;Tarragona;8;Penedès;12;Baix Penedès;43037;Calafell;3;2;;1905;527;831;1031;874;5;7;1019;1026
43;Tarragona;8;Penedès;12;Baix Penedès;43037;Calafell;3;3;;1850;618;839;1002;848;4;17;981;998
43;Tarragona;8;Penedès;12;Baix Penedès;43037;Calafell;3;4;;2191;651;842;1007;1184;10;5;992;997
43;Tarragona;8;Penedès;12;Baix Penedès;43037;Calafell;4;1;;828;204;281;358;470;3;3;352;355
8;Barcelona;2;Catalunya Central;42;Moianès;08034;Calders;1;1;;799;329;506;608;191;4;11;593;604
8;Barcelona;1;Barcelona;21;Maresme;08032;Caldes d'Estrac;1;1;;2116;734;1058;1374;742;12;16;1346;1362
17;Girona;3;Girona;34;Selva;17033;Caldes de Malavella;1;1;;1611;600;874;1108;503;6;6;1096;1102
17;Girona;3;Girona;34;Selva;17033;Caldes de Malavella;1;2;;1699;579;781;950;749;6;4;940;944
17;Girona;3;Girona;34;Selva;17033;Caldes de Malavella;1;3;;1047;402;606;755;292;2;7;746;753
17;Girona;3;Girona;34;Selva;17033;Caldes de Malavella;1;4;;1282;401;547;674;608;0;6;668;674
8;Barcelona;1;Barcelona;41;Vallès Oriental;08033;Caldes de Montbui;1;1;;1268;509;685;889;379;9;5;875;880
8;Barcelona;1;Barcelona;41;Vallès Oriental;08033;Caldes de Montbui;1;2;;1916;645;897;1139;777;8;12;1119;1131
8;Barcelona;1;Barcelona;41;Vallès Oriental;08033;Caldes de Montbui;1;3;;728;284;400;493;235;5;8;480;488
8;Barcelona;1;Barcelona;41;Vallès Oriental;08033;Caldes de Montbui;2;1;;1701;636;907;1170;531;7;12;1151;1163
8;Barcelona;1;Barcelona;41;Vallès Oriental;08033;Caldes de Montbui;3;1;;1424;499;692;885;539;7;15;863;878
8;Barcelona;1;Barcelona;41;Vallès Oriental;08033;Caldes de Montbui;3;2;;686;247;357;444;242;6;6;432;438
8;Barcelona;1;Barcelona;41;Vallès Oriental;08033;Caldes de Montbui;3;3;;1757;539;769;990;767;3;14;973;987
8;Barcelona;1;Barcelona;41;Vallès Oriental;08033;Caldes de Montbui;3;4;;1396;495;735;961;435;5;14;942;956
8;Barcelona;1;Barcelona;41;Vallès Oriental;08033;Caldes de Montbui;3;5;;1672;475;748;964;708;9;11;944;955
8;Barcelona;1;Barcelona;41;Vallès Oriental;08033;Caldes de Montbui;3;6;;719;272;412;516;203;2;7;507;514
8;Barcelona;1;Barcelona;21;Maresme;08035;Calella;1;1;;1261;447;625;759;502;5;5;749;754
8;Barcelona;1;Barcelona;21;Maresme;08035;Calella;1;2;;855;354;502;600;255;3;7;590;597
8;Barcelona;1;Barcelona;21;Maresme;08035;Calella;1;3;;1618;542;706;878;740;3;4;871;875
8;Barcelona;1;Barcelona;21;Maresme;08035;Calella;2;1;;740;291;413;486;254;2;4;480;484
8;Barcelona;1;Barcelona;21;Maresme;08035;Calella;2;2;;1634;607;853;1049;585;5;8;1036;1044
8;Barcelona;1;Barcelona;21;Maresme;08035;Calella;3;1;;1837;713;983;1209;628;9;6;1194;1200
8;Barcelona;1;Barcelona;21;Maresme;08035;Calella;3;2;;1842;737;961;1166;676;12;5;1149;1154
8;Barcelona;1;Barcelona;21;Maresme;08035;Calella;3;3;;1520;606;860;1045;475;4;3;1038;1041
8;Barcelona;1;Barcelona;21;Maresme;08035;Calella;3;4;;1760;543;809;1030;730;4;4;1022;1026
8;Barcelona;2;Catalunya Central;24;Osona;08037;Calldetenes;1;1;;1934;746;1139;1445;489;26;59;1360;1419
8;Barcelona;2;Catalunya Central;7;Bages;08038;Callús;1;1;;1539;585;858;1080;459;18;61;1001;1062
17;Girona;3;Girona;10;Baix Empordà;17034;Calonge i Sant Antoni;1;1;;2012;705;1036;1283;729;20;25;1238;1263
17;Girona;3;Girona;10;Baix Empordà;17034;Calonge i Sant Antoni;1;2;;1207;452;603;742;465;3;7;732;739
17;Girona;3;Girona;10;Baix Empordà;17034;Calonge i Sant Antoni;1;3;;1484;519;694;930;554;8;17;905;922
17;Girona;3;Girona;10;Baix Empordà;17034;Calonge i Sant Antoni;1;4;;1547;492;763;929;618;5;19;905;924
17;Girona;3;Girona;10;Baix Empordà;17034;Calonge i Sant Antoni;1;5;;1247;415;540;705;542;6;8;691;699
8;Barcelona;2;Catalunya Central;6;Anoia;08036;Calonge de Segarra;1;1;;163;82;119;139;24;5;2;132;134
25;Lleida;4;Lleida;23;Noguera;25062;Camarasa;1;1;;704;297;448;566;138;4;18;544;562
43;Tarragona;7;Terres de l'Ebre;9;Baix Ebre;43903;Camarles;1;1;;1697;784;942;1266;431;28;31;1207;1238
43;Tarragona;7;Terres de l'Ebre;9;Baix Ebre;43903;Camarles;1;2;;716;270;396;506;210;0;11;495;506
43;Tarragona;6;Camp de Tarragona;8;Baix Camp;43038;Cambrils;1;1;;1506;538;738;919;587;4;9;906;915
43;Tarragona;6;Camp de Tarragona;8;Baix Camp;43038;Cambrils;1;2;;1853;627;876;1114;739;4;7;1103;1110
43;Tarragona;6;Camp de Tarragona;8;Baix Camp;43038;Cambrils;1;3;;1882;619;894;1108;774;6;5;1097;1102
43;Tarragona;6;Camp de Tarragona;8;Baix Camp;43038;Cambrils;1;4;;801;286;391;506;295;0;1;505;506
43;Tarragona;6;Camp de Tarragona;8;Baix Camp;43038;Cambrils;1;5;;1328;501;704;890;438;1;7;882;889
43;Tarragona;6;Camp de Tarragona;8;Baix Camp;43038;Cambrils;1;6;;1254;389;522;695;559;5;4;686;690
43;Tarragona;6;Camp de Tarragona;8;Baix Camp;43038;Cambrils;2;1;;1286;510;695;833;453;7;12;814;826
43;Tarragona;6;Camp de Tarragona;8;Baix Camp;43038;Cambrils;2;10;;1078;350;487;630;448;1;7;622;629
43;Tarragona;6;Camp de Tarragona;8;Baix Camp;43038;Cambrils;2;2;;1055;359;477;627;428;5;3;619;622
43;Tarragona;6;Camp de Tarragona;8;Baix Camp;43038;Cambrils;2;3;;1666;589;832;1096;570;5;18;1073;1091
43;Tarragona;6;Camp de Tarragona;8;Baix Camp;43038;Cambrils;2;4;;931;310;417;536;395;4;6;526;532
43;Tarragona;6;Camp de Tarragona;8;Baix Camp;43038;Cambrils;2;5;;1411;483;655;878;533;3;4;871;875
43;Tarragona;6;Camp de Tarragona;8;Baix Camp;43038;Cambrils;2;6;;2094;593;846;1150;944;3;8;1139;1147
43;Tarragona;6;Camp de Tarragona;8;Baix Camp;43038;Cambrils;2;7;;1714;496;746;1024;690;5;13;1006;1019
43;Tarragona;6;Camp de Tarragona;8;Baix Camp;43038;Cambrils;2;8;;847;305;410;507;340;3;7;497;504
43;Tarragona;6;Camp de Tarragona;8;Baix Camp;43038;Cambrils;2;9;;1635;514;766;1045;590;2;14;1029;1043
17;Girona;3;Girona;28;Pla de l'Estany;17035;Camós;1;1;;548;267;379;465;83;10;8;447;455
17;Girona;3;Girona;31;Ripollès;17036;Campdevànol;1;1;;1092;448;628;801;291;21;34;746;780
17;Girona;3;Girona;31;Ripollès;17036;Campdevànol;1;2;;781;300;441;547;234;19;21;507;528
17;Girona;3;Girona;31;Ripollès;17036;Campdevànol;1;3;;768;258;398;525;243;23;24;478;502
17;Girona;3;Girona;31;Ripollès;17037;Campelles;1;1;;116;44;70;99;17;0;1;98;99
8;Barcelona;1;Barcelona;41;Vallès Oriental;08039;Campins;1;1;;406;175;244;319;87;2;16;301;317
17;Girona;3;Girona;20;Gironès;17038;Campllong;1;1;;382;169;257;317;65;5;7;305;312
17;Girona;3;Girona;31;Ripollès;17039;Camprodon;1;1;;1097;507;712;853;244;26;47;780;827
17;Girona;3;Girona;31;Ripollès;17039;Camprodon;1;2;;662;316;436;510;152;21;14;475;489
25;Lleida;5;Alt Pirineu i territori d'Aran;39;Consell General d'Aran;25063;Canejan;1;1;;92;44;52;78;14;1;0;77;77
17;Girona;3;Girona;20;Gironès;17040;Canet d'Adri;1;1;;558;302;383;461;97;7;13;441;454
8;Barcelona;1;Barcelona;21;Maresme;08040;Canet de Mar;1;1;;1563;622;909;1095;468;12;19;1064;1083
8;Barcelona;1;Barcelona;21;Maresme;08040;Canet de Mar;1;2;;1493;636;816;1016;477;12;7;997;1004
8;Barcelona;1;Barcelona;21;Maresme;08040;Canet de Mar;1;3;;1026;326;471;635;391;4;7;624;631
8;Barcelona;1;Barcelona;21;Maresme;08040;Canet de Mar;1;4;;1917;714;1044;1306;611;11;26;1269;1295
8;Barcelona;1;Barcelona;21;Maresme;08040;Canet de Mar;1;5;;1075;411;556;683;392;0;18;665;683
8;Barcelona;1;Barcelona;21;Maresme;08040;Canet de Mar;1;6;;1122;279;395;494;628;4;10;480;490
8;Barcelona;1;Barcelona;21;Maresme;08040;Canet de Mar;1;7;;1995;714;1068;1342;653;14;22;1306;1328
8;Barcelona;1;Barcelona;21;Maresme;08040;Canet de Mar;1;8;;917;279;413;580;337;4;12;564;576
43;Tarragona;6;Camp de Tarragona;36;Tarragonès;43907;Canonja, la;1;1;;1182;430;611;768;414;5;1;762;763
43;Tarragona;6;Camp de Tarragona;36;Tarragonès;43907;Canonja, la;1;2;;1125;380;527;689;436;1;4;684;688
43;Tarragona;6;Camp de Tarragona;36;Tarragonès;43907;Canonja, la;1;3;;921;357;506;637;284;9;1;627;628
43;Tarragona;6;Camp de Tarragona;36;Tarragonès;43907;Canonja, la;1;4;;1148;424;544;689;459;2;3;684;687
8;Barcelona;1;Barcelona;41;Vallès Oriental;08041;Canovelles;1;1;;1622;549;780;1031;591;5;3;1023;1026
8;Barcelona;1;Barcelona;41;Vallès Oriental;08041;Canovelles;1;2;;1245;399;521;636;609;1;3;632;635
8;Barcelona;1;Barcelona;41;Vallès Oriental;08041;Canovelles;1;3;;1272;320;444;556;716;6;3;547;550
8;Barcelona;1;Barcelona;41;Vallès Oriental;08041;Canovelles;1;4;;1238;295;408;581;657;4;8;569;577
8;Barcelona;1;Barcelona;41;Vallès Oriental;08041;Canovelles;1;5;;953;265;378;460;493;3;1;456;457
8;Barcelona;1;Barcelona;41;Vallès Oriental;08041;Canovelles;1;6;;1338;523;711;872;466;5;8;859;867
8;Barcelona;1;Barcelona;41;Vallès Oriental;08041;Canovelles;1;7;;1463;481;721;928;535;10;9;909;918
8;Barcelona;1;Barcelona;41;Vallès Oriental;08041;Canovelles;1;8;;1593;535;870;1067;526;7;4;1056;1060
8;Barcelona;1;Barcelona;41;Vallès Oriental;08042;Cànoves i Samalús;1;1;;1205;464;690;880;325;5;8;867;875
8;Barcelona;1;Barcelona;41;Vallès Oriental;08042;Cànoves i Samalús;1;2;;1184;498;693;896;288;2;8;886;894
17;Girona;3;Girona;2;Alt Empordà;17041;Cantallops;1;1;;233;97;127;158;75;2;9;147;156
8;Barcelona;8;Penedès;17;Garraf;08043;Canyelles;1;1;;1898;741;1051;1268;630;8;30;1230;1260
8;Barcelona;8;Penedès;17;Garraf;08043;Canyelles;1;2;;1559;541;811;983;576;10;9;964;973
43;Tarragona;6;Camp de Tarragona;8;Baix Camp;43039;Capafonts;1;1;;107;51;66;94;13;0;0;94;94
43;Tarragona;6;Camp de Tarragona;29;Priorat;43040;Capçanes;1;1;;329;157;200;239;90;13;42;184;226
8;Barcelona;8;Penedès;6;Anoia;08044;Capellades;1;1;;1838;676;947;1182;656;7;7;1168;1175
8;Barcelona;8;Penedès;6;Anoia;08044;Capellades;2;1;;1048;435;577;747;301;5;10;732;742
8;Barcelona;8;Penedès;6;Anoia;08044;Capellades;2;2;;1274;475;756;907;367;14;11;882;893
17;Girona;3;Girona;2;Alt Empordà;17042;Capmany;1;1;;418;185;255;294;124;20;31;243;274
8;Barcelona;2;Catalunya Central;14;Berguedà;08045;Capolat;1;1;;72;33;46;61;11;1;0;60;60
8;Barcelona;1;Barcelona;41;Vallès Oriental;08046;Cardedeu;1;1;;1052;390;563;706;346;1;6;699;705
8;Barcelona;1;Barcelona;41;Vallès Oriental;08046;Cardedeu;1;2;;1515;581;845;1093;422;8;11;1074;1085
8;Barcelona;1;Barcelona;41;Vallès Oriental;08046;Cardedeu;1;3;;1212;455;640;799;413;6;8;785;793
8;Barcelona;1;Barcelona;41;Vallès Oriental;08046;Cardedeu;2;1;;1925;675;987;1255;670;8;7;1240;1247
8;Barcelona;1;Barcelona;41;Vallès Oriental;08046;Cardedeu;2;2;;1468;517;763;1011;457;3;9;999;1008
8;Barcelona;1;Barcelona;41;Vallès Oriental;08046;Cardedeu;2;3;;1358;478;740;985;373;3;8;974;982
8;Barcelona;1;Barcelona;41;Vallès Oriental;08046;Cardedeu;2;4;;2354;868;1273;1654;700;9;17;1628;1645
8;Barcelona;1;Barcelona;41;Vallès Oriental;08046;Cardedeu;3;1;;2681;849;1278;1666;1015;4;15;1647;1662
8;Barcelona;2;Catalunya Central;7;Bages;08047;Cardona;1;1;;793;309;468;572;221;8;11;553;564
8;Barcelona;2;Catalunya Central;7;Bages;08047;Cardona;1;2;;1281;496;780;939;342;20;14;905;919
8;Barcelona;2;Catalunya Central;7;Bages;08047;Cardona;1;3;;771;296;479;586;185;2;5;579;584
8;Barcelona;2;Catalunya Central;7;Bages;08047;Cardona;2;1;;901;385;562;686;215;4;13;669;682
8;Barcelona;8;Penedès;6;Anoia;08048;Carme;1;1;;602;235;340;418;184;26;41;351;392
43;Tarragona;7;Terres de l'Ebre;37;Terra Alta;43041;Caseres;1;1;;227;95;155;182;45;10;20;152;172
17;Girona;3;Girona;20;Gironès;17044;Cassà de la Selva;1;1;;1645;635;931;1233;412;6;27;1200;1227
17;Girona;3;Girona;20;Gironès;17044;Cassà de la Selva;1;2;;1137;491;675;804;333;12;10;782;792
17;Girona;3;Girona;20;Gironès;17044;Cassà de la Selva;2;1;;1902;739;1037;1283;619;16;39;1228;1267
17;Girona;3;Girona;20;Gironès;17044;Cassà de la Selva;2;2;;1610;628;896;1095;515;22;21;1052;1073
17;Girona;3;Girona;20;Gironès;17044;Cassà de la Selva;2;3;;689;311;454;517;172;8;18;491;509
8;Barcelona;2;Catalunya Central;14;Berguedà;08049;Casserres;1;1;;1320;443;677;871;449;31;94;746;840
25;Lleida;2;Catalunya Central;35;Solsonès;25064;Castellar de la Ribera;1;1;;99;42;71;92;7;2;0;90;90
8;Barcelona;2;Catalunya Central;14;Berguedà;08050;Castellar del Riu;1;1;;138;72;97;118;20;1;2;115;117
8;Barcelona;1;Barcelona;40;Vallès Occidental;08051;Castellar del Vallès;1;1;;914;295;495;642;272;0;6;636;642
8;Barcelona;1;Barcelona;40;Vallès Occidental;08051;Castellar del Vallès;1;10;;1119;411;606;789;330;1;6;782;788
8;Barcelona;1;Barcelona;40;Vallès Occidental;08051;Castellar del Vallès;1;11;;885;284;434;591;294;0;4;587;591
8;Barcelona;1;Barcelona;40;Vallès Occidental;08051;Castellar del Vallès;1;12;;820;255;374;487;333;2;4;481;485
8;Barcelona;1;Barcelona;40;Vallès Occidental;08051;Castellar del Vallès;1;13;;1472;475;718;995;477;1;14;980;994
8;Barcelona;1;Barcelona;40;Vallès Occidental;08051;Castellar del Vallès;1;14;;1191;410;605;819;372;0;6;813;819
8;Barcelona;1;Barcelona;40;Vallès Occidental;08051;Castellar del Vallès;1;2;;1134;425;634;835;299;1;8;826;834
8;Barcelona;1;Barcelona;40;Vallès Occidental;08051;Castellar del Vallès;1;3;;1431;442;681;910;521;2;11;897;908
8;Barcelona;1;Barcelona;40;Vallès Occidental;08051;Castellar del Vallès;1;4;;1599;588;846;1076;523;0;6;1070;1076
8;Barcelona;1;Barcelona;40;Vallès Occidental;08051;Castellar del Vallès;1;5;;1375;533;772;1014;361;1;6;1007;1013
8;Barcelona;1;Barcelona;40;Vallès Occidental;08051;Castellar del Vallès;1;6;;1338;421;537;723;615;4;1;718;719
8;Barcelona;1;Barcelona;40;Vallès Occidental;08051;Castellar del Vallès;1;7;;1788;666;917;1188;600;0;13;1175;1188
8;Barcelona;1;Barcelona;40;Vallès Occidental;08051;Castellar del Vallès;1;8;;1606;601;813;1087;519;6;3;1078;1081
8;Barcelona;1;Barcelona;40;Vallès Occidental;08051;Castellar del Vallès;1;9;;1860;620;972;1279;581;2;10;1267;1277
8;Barcelona;2;Catalunya Central;14;Berguedà;08052;Castellar de n'Hug;1;1;;144;52;81;121;23;4;5;112;117
8;Barcelona;2;Catalunya Central;7;Bages;08053;Castellbell i el Vilar;1;1;;1431;597;828;1041;390;11;11;1019;1030
8;Barcelona;2;Catalunya Central;7;Bages;08053;Castellbell i el Vilar;1;2;;1446;482;652;818;628;5;9;804;813
8;Barcelona;1;Barcelona;40;Vallès Occidental;08054;Castellbisbal;1;1;;1870;693;964;1286;584;8;9;1269;1278
8;Barcelona;1;Barcelona;40;Vallès Occidental;08054;Castellbisbal;1;2;;832;327;438;584;248;5;5;574;579
8;Barcelona;1;Barcelona;40;Vallès Occidental;08054;Castellbisbal;1;3;;1492;502;785;1052;440;7;9;1036;1045
8;Barcelona;1;Barcelona;40;Vallès Occidental;08054;Castellbisbal;1;4;;1765;651;953;1265;500;9;13;1243;1256
8;Barcelona;1;Barcelona;40;Vallès Occidental;08054;Castellbisbal;1;5;;1793;605;863;1127;666;7;8;1112;1120
8;Barcelona;1;Barcelona;40;Vallès Occidental;08054;Castellbisbal;1;6;;1472;414;623;796;676;8;5;783;788
8;Barcelona;1;Barcelona;42;Moianès;08055;Castellcir;1;1;;548;224;307;379;169;21;46;312;358
25;Lleida;4;Lleida;18;Garrigues;25067;Castelldans;1;1;;711;288;431;540;171;9;11;520;531
8;Barcelona;1;Barcelona;11;Baix Llobregat;08056;Castelldefels;1;1;;725;226;309;384;341;3;3;378;381
8;Barcelona;1;Barcelona;11;Baix Llobregat;08056;Castelldefels;1;2;;1534;474;685;870;664;5;11;854;865
8;Barcelona;1;Barcelona;11;Baix Llobregat;08056;Castelldefels;1;3;;2192;756;1125;1460;732;6;15;1439;1454
8;Barcelona;1;Barcelona;11;Baix Llobregat;08056;Castelldefels;1;4;;1608;508;752;950;658;5;13;932;945
8;Barcelona;1;Barcelona;11;Baix Llobregat;08056;Castelldefels;1;5;;1334;516;696;825;509;4;4;817;821
8;Barcelona;1;Barcelona;11;Baix Llobregat;08056;Castelldefels;1;6;;1930;724;982;1212;718;8;6;1198;1204
8;Barcelona;1;Barcelona;11;Baix Llobregat;08056;Castelldefels;1;7;;2616;813;1321;1701;915;5;19;1677;1696
8;Barcelona;1;Barcelona;11;Baix Llobregat;08056;Castelldefels;2;1;;1295;504;699;870;425;2;11;857;868
8;Barcelona;1;Barcelona;11;Baix Llobregat;08056;Castelldefels;2;2;;1251;474;684;843;408;2;4;837;841
8;Barcelona;1;Barcelona;11;Baix Llobregat;08056;Castelldefels;2;3;;1301;423;603;781;520;4;7;770;777
8;Barcelona;1;Barcelona;11;Baix Llobregat;08056;Castelldefels;2;4;;1992;682;969;1213;779;6;7;1200;1207
8;Barcelona;1;Barcelona;11;Baix Llobregat;08056;Castelldefels;2;5;;1363;508;721;916;447;7;9;900;909
8;Barcelona;1;Barcelona;11;Baix Llobregat;08056;Castelldefels;2;6;;1197;432;592;716;481;1;11;704;715
8;Barcelona;1;Barcelona;11;Baix Llobregat;08056;Castelldefels;3;1;;811;287;420;504;307;3;2;499;501
8;Barcelona;1;Barcelona;11;Baix Llobregat;08056;Castelldefels;3;2;;1477;483;741;978;499;1;2;975;977
8;Barcelona;1;Barcelona;11;Baix Llobregat;08056;Castelldefels;3;3;;2051;657;972;1280;771;6;10;1264;1274
8;Barcelona;1;Barcelona;11;Baix Llobregat;08056;Castelldefels;3;4;;1800;662;977;1269;531;3;19;1247;1266
8;Barcelona;1;Barcelona;11;Baix Llobregat;08056;Castelldefels;3;5;;862;323;482;642;220;1;5;636;641
8;Barcelona;1;Barcelona;11;Baix Llobregat;08056;Castelldefels;4;1;;2553;888;1316;1664;889;2;15;1647;1662
8;Barcelona;1;Barcelona;11;Baix Llobregat;08056;Castelldefels;4;2;;1611;437;700;898;713;1;2;895;897
8;Barcelona;1;Barcelona;11;Baix Llobregat;08056;Castelldefels;4;3;;1834;513;762;988;846;5;6;977;983
8;Barcelona;1;Barcelona;11;Baix Llobregat;08056;Castelldefels;4;4;;2278;652;914;1218;1060;1;5;1212;1217
8;Barcelona;1;Barcelona;11;Baix Llobregat;08056;Castelldefels;5;1;;2316;796;1118;1486;830;0;5;1481;1486
8;Barcelona;1;Barcelona;11;Baix Llobregat;08056;Castelldefels;5;2;;2211;549;893;1214;997;4;11;1199;1210
8;Barcelona;1;Barcelona;11;Baix Llobregat;08056;Castelldefels;5;3;;1973;544;761;988;985;3;11;974;985
8;Barcelona;1;Barcelona;11;Baix Llobregat;08056;Castelldefels;5;4;;1829;606;960;1213;616;3;6;1204;1210
8;Barcelona;2;Catalunya Central;14;Berguedà;08057;Castell de l'Areny;1;1;;61;29;37;47;14;0;2;45;47
25;Lleida;5;Alt Pirineu i territori d'Aran;25;Pallars Jussà;25904;Castell de Mur;1;1;;164;71;117;140;24;3;0;137;137
8;Barcelona;8;Penedès;3;Alt Penedès;08058;Castellet i la Gornal;1;1;;1810;657;916;1157;653;13;19;1125;1144
17;Girona;3;Girona;19;Garrotxa;17046;Castellfollit de la Roca;1;1;;719;324;454;543;176;16;21;506;527
8;Barcelona;2;Catalunya Central;7;Bages;08059;Castellfollit del Boix;1;1;;347;124;197;276;71;4;11;261;272
8;Barcelona;2;Catalunya Central;6;Anoia;08060;Castellfollit de Riubregós;1;1;;137;67;102;122;15;6;0;116;116
8;Barcelona;2;Catalunya Central;7;Bages;08061;Castellgalí;1;1;;1607;607;865;1102;505;12;15;1075;1090
8;Barcelona;2;Catalunya Central;7;Bages;08062;Castellnou de Bages;1;1;;1005;413;601;758;247;1;10;747;757
25;Lleida;4;Lleida;27;Pla d'Urgell;25068;Castellnou de Seana;1;1;;525;233;342;402;123;6;11;385;396
17;Girona;3;Girona;2;Alt Empordà;17047;Castelló d'Empúries;1;1;;1395;500;693;842;553;6;5;831;836
17;Girona;3;Girona;2;Alt Empordà;17047;Castelló d'Empúries;1;2;;1258;535;726;877;381;6;15;856;871
17;Girona;3;Girona;2;Alt Empordà;17047;Castelló d'Empúries;1;3;;1636;457;628;766;870;6;11;749;760
17;Girona;3;Girona;2;Alt Empordà;17047;Castelló d'Empúries;1;4;;1310;313;452;612;698;3;3;606;609
25;Lleida;4;Lleida;23;Noguera;25069;Castelló de Farfanya;1;1;;426;189;290;363;63;4;1;358;359
8;Barcelona;8;Penedès;6;Anoia;08063;Castellolí;1;1;;473;201;313;383;90;9;36;338;374
17;Girona;3;Girona;10;Baix Empordà;17048;Castell-Platja d'Aro;1;1;;1326;483;710;882;444;3;5;874;879
17;Girona;3;Girona;10;Baix Empordà;17048;Castell-Platja d'Aro;1;2;;1964;561;793;991;973;9;15;967;982
17;Girona;3;Girona;10;Baix Empordà;17048;Castell-Platja d'Aro;1;3;;1777;648;895;1103;674;8;14;1081;1095
17;Girona;3;Girona;10;Baix Empordà;17048;Castell-Platja d'Aro;1;4;;859;245;327;439;420;1;4;434;438
17;Girona;3;Girona;10;Baix Empordà;17048;Castell-Platja d'Aro;1;5;;963;319;443;553;410;5;4;544;548
25;Lleida;4;Lleida;38;Urgell;25070;Castellserà;1;1;;814;389;512;643;171;12;17;614;631
8;Barcelona;1;Barcelona;42;Moianès;08064;Castellterçol;1;1;;1929;686;1021;1288;641;66;77;1145;1222
43;Tarragona;6;Camp de Tarragona;8;Baix Camp;43042;Castellvell del Camp;1;1;;808;366;482;612;196;12;11;589;600
43;Tarragona;6;Camp de Tarragona;8;Baix Camp;43042;Castellvell del Camp;1;2;;1407;554;749;979;428;0;17;962;979
8;Barcelona;8;Penedès;3;Alt Penedès;08065;Castellví de la Marca;1;1;;1182;444;725;899;283;21;33;845;878
8;Barcelona;1;Barcelona;11;Baix Llobregat;08066;Castellví de Rosanes;1;1;;1473;531;790;1031;442;6;14;1011;1025
43;Tarragona;6;Camp de Tarragona;36;Tarragonès;43043;Catllar, el;1;1;;1922;741;977;1296;626;10;19;1267;1286
43;Tarragona;6;Camp de Tarragona;36;Tarragonès;43043;Catllar, el;1;2;;1415;518;677;896;519;5;5;886;891
25;Lleida;5;Alt Pirineu i territori d'Aran;4;Alt Urgell;25071;Cava;1;1;;44;16;22;36;8;0;0;36;36
17;Girona;3;Girona;34;Selva;17189;Cellera de Ter, la;1;1;;785;355;523;616;169;45;36;535;571
17;Girona;3;Girona;34;Selva;17189;Cellera de Ter, la;1;2;;696;295;434;551;145;32;22;497;519
17;Girona;3;Girona;20;Gironès;17049;Celrà;1;1;;1275;548;826;1028;247;4;11;1013;1024
17;Girona;3;Girona;20;Gironès;17049;Celrà;1;2;;1433;559;842;1034;399;10;15;1009;1024
17;Girona;3;Girona;20;Gironès;17049;Celrà;1;3;;672;258;375;471;201;0;9;462;471
8;Barcelona;2;Catalunya Central;24;Osona;08067;Centelles;1;1;;1298;522;737;917;381;11;21;885;906
8;Barcelona;2;Catalunya Central;24;Osona;08067;Centelles;1;2;;1050;400;595;732;318;5;17;710;727
8;Barcelona;2;Catalunya Central;24;Osona;08067;Centelles;1;3;;1422;573;820;997;425;13;24;960;984
8;Barcelona;2;Catalunya Central;24;Osona;08067;Centelles;1;4;;1971;746;1090;1361;610;8;38;1315;1353
8;Barcelona;2;Catalunya Central;14;Berguedà;08268;Cercs;1;1;;436;155;266;325;111;7;7;311;318
8;Barcelona;2;Catalunya Central;14;Berguedà;08268;Cercs;1;2;;541;227;312;384;157;8;17;359;376
8;Barcelona;1;Barcelona;40;Vallès Occidental;08266;Cerdanyola del Vallès;1;1;;1856;628;887;1141;715;3;10;1128;1138
8;Barcelona;1;Barcelona;40;Vallès Occidental;08266;Cerdanyola del Vallès;1;10;;1620;545;783;1054;566;5;13;1036;1049
8;Barcelona;1;Barcelona;40;Vallès Occidental;08266;Cerdanyola del Vallès;1;11;;1445;362;522;647;798;2;1;644;645
8;Barcelona;1;Barcelona;40;Vallès Occidental;08266;Cerdanyola del Vallès;1;12;;1847;688;973;1223;624;5;8;1210;1218
8;Barcelona;1;Barcelona;40;Vallès Occidental;08266;Cerdanyola del Vallès;1;13;;860;228;437;586;274;4;0;582;582
8;Barcelona;1;Barcelona;40;Vallès Occidental;08266;Cerdanyola del Vallès;1;14;;1568;523;809;1065;503;1;3;1061;1064
8;Barcelona;1;Barcelona;40;Vallès Occidental;08266;Cerdanyola del Vallès;1;15;;1536;623;802;992;544;7;0;985;985
8;Barcelona;1;Barcelona;40;Vallès Occidental;08266;Cerdanyola del Vallès;1;16;;1243;496;676;823;420;2;4;817;821
8;Barcelona;1;Barcelona;40;Vallès Occidental;08266;Cerdanyola del Vallès;1;17;;1513;542;691;935;578;2;4;929;933
8;Barcelona;1;Barcelona;40;Vallès Occidental;08266;Cerdanyola del Vallès;1;18;;1263;487;663;874;389;0;6;868;874
8;Barcelona;1;Barcelona;40;Vallès Occidental;08266;Cerdanyola del Vallès;1;19;;1662;650;863;1112;550;4;16;1092;1108
8;Barcelona;1;Barcelona;40;Vallès Occidental;08266;Cerdanyola del Vallès;1;2;;1624;580;835;1081;543;10;7;1064;1071
8;Barcelona;1;Barcelona;40;Vallès Occidental;08266;Cerdanyola del Vallès;1;20;;993;333;518;686;307;1;16;669;685
8;Barcelona;1;Barcelona;40;Vallès Occidental;08266;Cerdanyola del Vallès;1;27;;1290;481;605;729;561;7;0;722;722
8;Barcelona;1;Barcelona;40;Vallès Occidental;08266;Cerdanyola del Vallès;1;28;;1363;481;734;964;399;0;6;958;964
8;Barcelona;1;Barcelona;40;Vallès Occidental;08266;Cerdanyola del Vallès;1;29;;1572;549;798;1079;493;5;10;1064;1074
8;Barcelona;1;Barcelona;40;Vallès Occidental;08266;Cerdanyola del Vallès;1;3;;1219;472;630;805;414;2;5;798;803
8;Barcelona;1;Barcelona;40;Vallès Occidental;08266;Cerdanyola del Vallès;1;30;;1914;707;1052;1369;545;4;9;1356;1365
8;Barcelona;1;Barcelona;40;Vallès Occidental;08266;Cerdanyola del Vallès;1;31;;842;355;485;607;235;0;7;600;607
8;Barcelona;1;Barcelona;40;Vallès Occidental;08266;Cerdanyola del Vallès;1;32;;630;243;367;469;161;0;1;468;469
8;Barcelona;1;Barcelona;40;Vallès Occidental;08266;Cerdanyola del Vallès;1;33;;1077;434;675;728;349;4;4;720;724
8;Barcelona;1;Barcelona;40;Vallès Occidental;08266;Cerdanyola del Vallès;1;34;;1474;480;742;949;525;3;3;943;946
8;Barcelona;1;Barcelona;40;Vallès Occidental;08266;Cerdanyola del Vallès;1;35;;1700;512;835;1115;585;4;12;1099;1111
8;Barcelona;1;Barcelona;40;Vallès Occidental;08266;Cerdanyola del Vallès;1;36;;1143;397;606;786;357;0;2;784;786
8;Barcelona;1;Barcelona;40;Vallès Occidental;08266;Cerdanyola del Vallès;1;37;;950;280;401;586;364;1;4;581;585
8;Barcelona;1;Barcelona;40;Vallès Occidental;08266;Cerdanyola del Vallès;1;38;;855;271;432;579;276;1;5;573;578
8;Barcelona;1;Barcelona;40;Vallès Occidental;08266;Cerdanyola del Vallès;1;39;;782;278;409;521;261;1;5;515;520
8;Barcelona;1;Barcelona;40;Vallès Occidental;08266;Cerdanyola del Vallès;1;4;;1212;431;581;713;499;3;3;707;710
8;Barcelona;1;Barcelona;40;Vallès Occidental;08266;Cerdanyola del Vallès;1;40;;1124;410;597;837;287;2;10;825;835
8;Barcelona;1;Barcelona;40;Vallès Occidental;08266;Cerdanyola del Vallès;1;5;;790;298;391;498;292;5;3;490;493
8;Barcelona;1;Barcelona;40;Vallès Occidental;08266;Cerdanyola del Vallès;1;6;;1371;454;658;917;454;5;4;908;912
8;Barcelona;1;Barcelona;40;Vallès Occidental;08266;Cerdanyola del Vallès;1;7;;626;261;353;440;186;3;2;435;437
8;Barcelona;1;Barcelona;40;Vallès Occidental;08266;Cerdanyola del Vallès;1;8;;1256;469;646;820;436;4;5;811;816
8;Barcelona;1;Barcelona;40;Vallès Occidental;08266;Cerdanyola del Vallès;1;9;;1326;528;725;923;403;5;5;913;918
8;Barcelona;1;Barcelona;11;Baix Llobregat;08068;Cervelló;1;1;;1959;771;1067;1355;604;7;18;1330;1348
8;Barcelona;1;Barcelona;11;Baix Llobregat;08068;Cervelló;1;2;;1623;510;766;995;628;10;3;982;985
8;Barcelona;1;Barcelona;11;Baix Llobregat;08068;Cervelló;1;3;;834;310;421;550;284;2;5;543;548
8;Barcelona;1;Barcelona;11;Baix Llobregat;08068;Cervelló;1;4;;1913;665;938;1222;691;3;12;1207;1219
8;Barcelona;1;Barcelona;11;Baix Llobregat;08068;Cervelló;1;5;;612;211;285;374;238;4;1;369;370
25;Lleida;4;Lleida;32;Segarra;25072;Cervera;1;1;;807;298;412;495;312;7;5;483;488
25;Lleida;4;Lleida;32;Segarra;25072;Cervera;2;1;;1066;405;589;753;313;13;12;728;740
25;Lleida;4;Lleida;32;Segarra;25072;Cervera;2;2;;1360;442;645;832;528;6;15;811;826
25;Lleida;4;Lleida;32;Segarra;25072;Cervera;2;3;;897;326;463;633;264;9;13;611;624
25;Lleida;4;Lleida;32;Segarra;25072;Cervera;3;1;;1791;633;915;1161;630;13;30;1118;1148
25;Lleida;4;Lleida;18;Garrigues;25073;Cervià de les Garrigues;1;1;;549;205;279;364;185;8;46;310;356
17;Girona;3;Girona;20;Gironès;17050;Cervià de Ter;1;1;;688;334;485;591;97;11;22;558;580
17;Girona;3;Girona;2;Alt Empordà;17051;Cistella;1;1;;220;85;138;161;59;9;20;132;152
25;Lleida;4;Lleida;38;Urgell;25074;Ciutadilla;1;1;;179;81;124;158;21;9;6;143;149
25;Lleida;2;Catalunya Central;35;Solsonès;25075;Clariana de Cardener;1;1;;132;66;88;121;11;0;0;121;121
25;Lleida;4;Lleida;18;Garrigues;25076;Cogul, el;1;1;;134;50;76;93;41;5;2;86;88
17;Girona;3;Girona;2;Alt Empordà;17054;Colera;1;1;;373;145;194;243;130;11;38;194;232
8;Barcelona;1;Barcelona;11;Baix Llobregat;08069;Collbató;1;1;;1878;715;1039;1328;550;19;25;1284;1309
8;Barcelona;1;Barcelona;11;Baix Llobregat;08069;Collbató;1;3;;1428;515;735;905;523;7;13;885;898
43;Tarragona;6;Camp de Tarragona;8;Baix Camp;43045;Colldejou;1;1;;146;87;113;130;16;2;1;127;128
25;Lleida;5;Alt Pirineu i territori d'Aran;4;Alt Urgell;25077;Coll de Nargó;1;1;;439;178;265;343;96;1;2;340;342
8;Barcelona;2;Catalunya Central;42;Moianès;08070;Collsuspina;1;1;;268;134;207;240;28;2;12;226;238
17;Girona;3;Girona;10;Baix Empordà;17055;Colomers;1;1;;147;74;98;119;28;8;5;106;111
25;Lleida;2;Catalunya Central;35;Solsonès;25163;Coma i la Pedra, la;1;1;;236;98;148;183;53;6;4;173;177
25;Lleida;5;Alt Pirineu i territori d'Aran;25;Pallars Jussà;25161;Conca de Dalt;1;1;;351;103;148;225;126;17;61;147;208
43;Tarragona;6;Camp de Tarragona;16;Conca de Barberà;43046;Conesa;1;1;;91;52;65;76;15;4;12;60;72
43;Tarragona;6;Camp de Tarragona;36;Tarragonès;43047;Constantí;1;1;;1437;539;742;919;518;5;5;909;914
43;Tarragona;6;Camp de Tarragona;36;Tarragonès;43047;Constantí;1;2;;906;244;331;435;471;2;0;433;433
43;Tarragona;6;Camp de Tarragona;36;Tarragonès;43047;Constantí;2;1;;1916;702;965;1197;719;18;12;1167;1179
8;Barcelona;8;Penedès;6;Anoia;08071;Copons;1;1;;240;119;173;206;34;1;3;202;205
43;Tarragona;7;Terres de l'Ebre;37;Terra Alta;43048;Corbera d'Ebre;1;1;;781;387;528;635;146;19;10;606;616
8;Barcelona;1;Barcelona;11;Baix Llobregat;08072;Corbera de Llobregat;1;1;;980;258;392;520;460;4;6;510;516
8;Barcelona;1;Barcelona;11;Baix Llobregat;08072;Corbera de Llobregat;1;10;;1118;354;495;645;473;2;8;635;643
8;Barcelona;1;Barcelona;11;Baix Llobregat;08072;Corbera de Llobregat;1;11;;911;282;482;542;369;4;10;528;538
8;Barcelona;1;Barcelona;11;Baix Llobregat;08072;Corbera de Llobregat;1;2;;1891;638;907;1182;709;9;18;1155;1173
8;Barcelona;1;Barcelona;11;Baix Llobregat;08072;Corbera de Llobregat;1;3;;1122;365;506;651;471;2;8;641;649
8;Barcelona;1;Barcelona;11;Baix Llobregat;08072;Corbera de Llobregat;1;4;;695;248;364;450;245;6;3;441;444
8;Barcelona;1;Barcelona;11;Baix Llobregat;08072;Corbera de Llobregat;1;5;;797;243;346;464;333;2;6;456;462
8;Barcelona;1;Barcelona;11;Baix Llobregat;08072;Corbera de Llobregat;1;6;;994;247;375;513;481;2;3;508;511
8;Barcelona;1;Barcelona;11;Baix Llobregat;08072;Corbera de Llobregat;1;7;;837;282;403;492;345;0;6;486;492
8;Barcelona;1;Barcelona;11;Baix Llobregat;08072;Corbera de Llobregat;1;8;;865;306;446;548;317;2;10;536;546
8;Barcelona;1;Barcelona;11;Baix Llobregat;08072;Corbera de Llobregat;1;9;;603;165;269;330;273;4;10;316;326
25;Lleida;4;Lleida;33;Segrià;25078;Corbins;1;1;;1005;385;612;760;245;20;32;708;740
17;Girona;3;Girona;10;Baix Empordà;17057;Corçà;1;1;;994;426;624;788;206;1;25;762;787
8;Barcelona;1;Barcelona;11;Baix Llobregat;08073;Cornellà de Llobregat;1;1;;1816;631;937;1157;659;1;9;1147;1156
8;Barcelona;1;Barcelona;11;Baix Llobregat;08073;Cornellà de Llobregat;1;10;;1078;384;537;691;387;4;3;684;687
8;Barcelona;1;Barcelona;11;Baix Llobregat;08073;Cornellà de Llobregat;1;11;;817;318;421;515;302;0;2;513;515
8;Barcelona;1;Barcelona;11;Baix Llobregat;08073;Cornellà de Llobregat;1;12;;754;234;421;423;331;0;1;422;423
8;Barcelona;1;Barcelona;11;Baix Llobregat;08073;Cornellà de Llobregat;1;13;;1062;476;534;675;387;1;3;671;674
8;Barcelona;1;Barcelona;11;Baix Llobregat;08073;Cornellà de Llobregat;1;14;;994;329;510;676;318;0;6;670;676
8;Barcelona;1;Barcelona;11;Baix Llobregat;08073;Cornellà de Llobregat;1;2;;1352;554;754;940;412;0;4;936;940
8;Barcelona;1;Barcelona;11;Baix Llobregat;08073;Cornellà de Llobregat;1;3;;1088;385;544;683;405;4;3;676;679
8;Barcelona;1;Barcelona;11;Baix Llobregat;08073;Cornellà de Llobregat;1;4;;1615;504;808;1039;576;1;23;1015;1038
8;Barcelona;1;Barcelona;11;Baix Llobregat;08073;Cornellà de Llobregat;1;5;;893;323;429;550;343;1;1;548;549
8;Barcelona;1;Barcelona;11;Baix Llobregat;08073;Cornellà de Llobregat;1;6;;626;194;299;401;225;0;0;401;401
8;Barcelona;1;Barcelona;11;Baix Llobregat;08073;Cornellà de Llobregat;1;7;;1541;550;812;1094;447;2;4;1088;1092
8;Barcelona;1;Barcelona;11;Baix Llobregat;08073;Cornellà de Llobregat;1;8;;1412;436;653;891;521;2;1;888;889
8;Barcelona;1;Barcelona;11;Baix Llobregat;08073;Cornellà de Llobregat;1;9;;776;294;400;507;269;3;1;503;504
8;Barcelona;1;Barcelona;11;Baix Llobregat;08073;Cornellà de Llobregat;2;1;;1353;374;592;829;524;3;5;821;826
8;Barcelona;1;Barcelona;11;Baix Llobregat;08073;Cornellà de Llobregat;2;2;;1989;573;928;1267;722;1;5;1261;1266
8;Barcelona;1;Barcelona;11;Baix Llobregat;08073;Cornellà de Llobregat;2;3;;1203;393;589;779;424;2;3;774;777
8;Barcelona;1;Barcelona;11;Baix Llobregat;08073;Cornellà de Llobregat;3;1;;999;354;511;627;372;2;2;623;625
8;Barcelona;1;Barcelona;11;Baix Llobregat;08073;Cornellà de Llobregat;3;10;;1503;458;736;969;534;1;4;964;968
8;Barcelona;1;Barcelona;11;Baix Llobregat;08073;Cornellà de Llobregat;3;2;;692;219;330;395;297;0;1;394;395
8;Barcelona;1;Barcelona;11;Baix Llobregat;08073;Cornellà de Llobregat;3;3;;696;229;332;430;266;0;0;430;430
8;Barcelona;1;Barcelona;11;Baix Llobregat;08073;Cornellà de Llobregat;3;4;;1592;508;824;1122;470;0;9;1113;1122
8;Barcelona;1;Barcelona;11;Baix Llobregat;08073;Cornellà de Llobregat;3;5;;1332;435;642;844;488;3;10;831;841
8;Barcelona;1;Barcelona;11;Baix Llobregat;08073;Cornellà de Llobregat;3;6;;699;262;352;471;228;1;3;467;470
8;Barcelona;1;Barcelona;11;Baix Llobregat;08073;Cornellà de Llobregat;3;7;;985;309;443;602;383;0;3;599;602
8;Barcelona;1;Barcelona;11;Baix Llobregat;08073;Cornellà de Llobregat;3;8;;1079;319;505;664;415;1;2;661;663
8;Barcelona;1;Barcelona;11;Baix Llobregat;08073;Cornellà de Llobregat;3;9;;718;214;309;392;326;3;2;387;389
8;Barcelona;1;Barcelona;11;Baix Llobregat;08073;Cornellà de Llobregat;4;1;;1002;368;489;668;334;3;3;662;665
8;Barcelona;1;Barcelona;11;Baix Llobregat;08073;Cornellà de Llobregat;4;10;;809;271;383;498;311;4;0;494;494
8;Barcelona;1;Barcelona;11;Baix Llobregat;08073;Cornellà de Llobregat;4;11;;827;291;380;497;330;1;3;493;496
8;Barcelona;1;Barcelona;11;Baix Llobregat;08073;Cornellà de Llobregat;4;12;;1022;343;465;616;406;1;3;612;615
8;Barcelona;1;Barcelona;11;Baix Llobregat;08073;Cornellà de Llobregat;4;13;;1253;427;629;792;461;2;5;785;790
8;Barcelona;1;Barcelona;11;Baix Llobregat;08073;Cornellà de Llobregat;4;14;;833;288;392;530;303;2;0;528;528
8;Barcelona;1;Barcelona;11;Baix Llobregat;08073;Cornellà de Llobregat;4;15;;838;273;376;484;354;7;0;477;477
8;Barcelona;1;Barcelona;11;Baix Llobregat;08073;Cornellà de Llobregat;4;16;;930;300;428;569;361;2;4;563;567
8;Barcelona;1;Barcelona;11;Baix Llobregat;08073;Cornellà de Llobregat;4;17;;901;346;439;545;356;1;0;544;544
8;Barcelona;1;Barcelona;11;Baix Llobregat;08073;Cornellà de Llobregat;4;18;;621;223;293;395;226;0;3;392;395
8;Barcelona;1;Barcelona;11;Baix Llobregat;08073;Cornellà de Llobregat;4;19;;645;223;313;381;264;0;0;381;381
8;Barcelona;1;Barcelona;11;Baix Llobregat;08073;Cornellà de Llobregat;4;2;;536;202;277;365;171;2;2;361;363
8;Barcelona;1;Barcelona;11;Baix Llobregat;08073;Cornellà de Llobregat;4;3;;1166;411;574;763;403;0;2;761;763
8;Barcelona;1;Barcelona;11;Baix Llobregat;08073;Cornellà de Llobregat;4;4;;767;245;370;459;308;1;0;458;458
8;Barcelona;1;Barcelona;11;Baix Llobregat;08073;Cornellà de Llobregat;4;5;;612;247;345;428;184;0;1;427;428
8;Barcelona;1;Barcelona;11;Baix Llobregat;08073;Cornellà de Llobregat;4;6;;938;361;466;598;340;1;3;594;597
8;Barcelona;1;Barcelona;11;Baix Llobregat;08073;Cornellà de Llobregat;4;7;;797;262;374;466;331;2;2;462;464
8;Barcelona;1;Barcelona;11;Baix Llobregat;08073;Cornellà de Llobregat;4;8;;1132;388;522;678;454;0;1;677;678
8;Barcelona;1;Barcelona;11;Baix Llobregat;08073;Cornellà de Llobregat;4;9;;663;231;307;409;254;1;1;407;408
8;Barcelona;1;Barcelona;11;Baix Llobregat;08073;Cornellà de Llobregat;5;1;;567;188;237;294;273;1;2;291;293
8;Barcelona;1;Barcelona;11;Baix Llobregat;08073;Cornellà de Llobregat;5;10;;771;247;331;428;343;0;5;423;428
8;Barcelona;1;Barcelona;11;Baix Llobregat;08073;Cornellà de Llobregat;5;2;;1073;259;364;460;613;4;0;456;456
8;Barcelona;1;Barcelona;11;Baix Llobregat;08073;Cornellà de Llobregat;5;3;;663;187;252;309;354;1;1;307;308
8;Barcelona;1;Barcelona;11;Baix Llobregat;08073;Cornellà de Llobregat;5;5;;590;196;253;318;272;1;2;315;317
8;Barcelona;1;Barcelona;11;Baix Llobregat;08073;Cornellà de Llobregat;5;6;;743;249;319;408;335;0;0;408;408
8;Barcelona;1;Barcelona;11;Baix Llobregat;08073;Cornellà de Llobregat;5;7;;723;195;270;357;366;1;4;352;356
8;Barcelona;1;Barcelona;11;Baix Llobregat;08073;Cornellà de Llobregat;5;8;;654;188;255;291;363;4;0;287;287
8;Barcelona;1;Barcelona;11;Baix Llobregat;08073;Cornellà de Llobregat;5;9;;713;167;383;493;220;2;1;490;491
8;Barcelona;1;Barcelona;11;Baix Llobregat;08073;Cornellà de Llobregat;6;1;;1524;459;564;753;771;4;4;745;749
8;Barcelona;1;Barcelona;11;Baix Llobregat;08073;Cornellà de Llobregat;6;10;;937;282;378;463;474;0;1;462;463
8;Barcelona;1;Barcelona;11;Baix Llobregat;08073;Cornellà de Llobregat;6;13;;535;151;218;274;261;5;0;269;269
8;Barcelona;1;Barcelona;11;Baix Llobregat;08073;Cornellà de Llobregat;6;14;;605;183;280;330;275;0;1;329;330
8;Barcelona;1;Barcelona;11;Baix Llobregat;08073;Cornellà de Llobregat;6;15;;897;316;431;591;306;0;1;590;591
8;Barcelona;1;Barcelona;11;Baix Llobregat;08073;Cornellà de Llobregat;6;4;;973;329;425;539;434;2;2;535;537
8;Barcelona;1;Barcelona;11;Baix Llobregat;08073;Cornellà de Llobregat;6;5;;964;334;433;519;445;1;2;516;518
8;Barcelona;1;Barcelona;11;Baix Llobregat;08073;Cornellà de Llobregat;6;7;;668;232;346;414;254;3;3;408;411
8;Barcelona;1;Barcelona;11;Baix Llobregat;08073;Cornellà de Llobregat;6;8;;924;295;398;509;415;4;7;498;505
8;Barcelona;1;Barcelona;11;Baix Llobregat;08073;Cornellà de Llobregat;6;9;;1478;524;717;899;579;0;5;894;899
17;Girona;3;Girona;28;Pla de l'Estany;17056;Cornellà del Terri;1;1;;1800;735;1107;1381;419;18;37;1326;1363
43;Tarragona;6;Camp de Tarragona;29;Priorat;43049;Cornudella de Montsant;1;1;;745;354;507;591;154;23;19;549;568
43;Tarragona;6;Camp de Tarragona;36;Tarragonès;43050;Creixell;1;1;;1363;510;702;875;488;12;11;852;863
43;Tarragona;6;Camp de Tarragona;36;Tarragonès;43050;Creixell;1;2;;1310;429;552;689;621;6;12;671;683
17;Girona;3;Girona;28;Pla de l'Estany;17058;Crespià;1;1;;176;89;121;146;30;1;5;140;145
17;Girona;3;Girona;10;Baix Empordà;17901;Cruïlles, Monells i Sant Sadurní;1;1;;1004;360;543;685;319;13;46;626;672
8;Barcelona;8;Penedès;17;Garraf;08074;Cubelles;1;1;;698;249;345;420;278;1;1;418;419
8;Barcelona;8;Penedès;17;Garraf;08074;Cubelles;1;10;;709;278;335;415;294;1;3;411;414
8;Barcelona;8;Penedès;17;Garraf;08074;Cubelles;1;2;;1212;409;599;748;464;1;1;746;747
8;Barcelona;8;Penedès;17;Garraf;08074;Cubelles;1;3;;1265;458;673;822;443;5;7;810;817
8;Barcelona;8;Penedès;17;Garraf;08074;Cubelles;1;4;;1798;641;776;1075;723;2;4;1069;1073
8;Barcelona;8;Penedès;17;Garraf;08074;Cubelles;1;5;;1478;480;782;884;594;2;7;875;882
8;Barcelona;8;Penedès;17;Garraf;08074;Cubelles;1;6;;1497;508;694;864;633;2;5;857;862
8;Barcelona;8;Penedès;17;Garraf;08074;Cubelles;1;7;;1033;345;457;535;498;4;2;529;531
8;Barcelona;8;Penedès;17;Garraf;08074;Cubelles;1;8;;842;198;311;400;442;4;4;392;396
8;Barcelona;8;Penedès;17;Garraf;08074;Cubelles;1;9;;666;263;323;380;286;5;2;373;375
25;Lleida;4;Lleida;23;Noguera;25079;Cubells;1;1;;285;131;191;244;41;10;8;226;234
43;Tarragona;8;Penedès;12;Baix Penedès;43051;Cunit;1;1;;1915;671;931;1143;772;10;9;1124;1133
43;Tarragona;8;Penedès;12;Baix Penedès;43051;Cunit;1;2;;1884;641;898;723;1161;8;8;707;715
43;Tarragona;8;Penedès;12;Baix Penedès;43051;Cunit;1;3;;1796;656;874;1046;750;9;7;1030;1037
43;Tarragona;8;Penedès;12;Baix Penedès;43051;Cunit;1;4;;1587;486;677;842;745;5;14;823;837
43;Tarragona;8;Penedès;12;Baix Penedès;43051;Cunit;1;5;;2058;669;928;1170;888;8;6;1156;1162
17;Girona;3;Girona;2;Alt Empordà;17060;Darnius;1;1;;413;187;266;310;103;3;10;297;307
17;Girona;5;Alt Pirineu i territori d'Aran;15;Cerdanya;17061;Das;1;1;;188;75;125;168;20;0;0;168;168
43;Tarragona;7;Terres de l'Ebre;9;Baix Ebre;43901;Deltebre;1;1;;1606;627;901;1131;475;5;13;1113;1126
43;Tarragona;7;Terres de l'Ebre;9;Baix Ebre;43901;Deltebre;1;2;;1842;794;1099;1356;486;6;16;1334;1350
43;Tarragona;7;Terres de l'Ebre;9;Baix Ebre;43901;Deltebre;1;3;;978;440;571;718;260;2;10;706;716
43;Tarragona;7;Terres de l'Ebre;9;Baix Ebre;43901;Deltebre;1;4;;1450;616;811;1068;382;5;7;1056;1063
43;Tarragona;7;Terres de l'Ebre;9;Baix Ebre;43901;Deltebre;1;5;;1313;530;743;965;348;7;13;945;958
43;Tarragona;7;Terres de l'Ebre;9;Baix Ebre;43901;Deltebre;1;6;;1649;703;985;1234;415;15;6;1213;1219
8;Barcelona;1;Barcelona;21;Maresme;08075;Dosrius;1;1;;1153;486;652;796;357;7;12;777;789
8;Barcelona;1;Barcelona;21;Maresme;08075;Dosrius;1;2;;2011;702;1077;1289;722;6;10;1273;1283
8;Barcelona;1;Barcelona;21;Maresme;08075;Dosrius;1;3;;940;331;508;650;290;1;6;643;649
43;Tarragona;6;Camp de Tarragona;8;Baix Camp;43053;Duesaigües;1;1;;189;82;134;168;21;7;1;160;161
17;Girona;3;Girona;2;Alt Empordà;17062;Escala, l';1;1;;808;317;460;535;273;1;9;525;534
17;Girona;3;Girona;2;Alt Empordà;17062;Escala, l';1;2;;1868;638;909;1141;727;10;31;1100;1131
17;Girona;3;Girona;2;Alt Empordà;17062;Escala, l';1;3;;1214;492;694;856;358;6;26;824;850
17;Girona;3;Girona;2;Alt Empordà;17062;Escala, l';1;4;;1150;432;615;742;408;5;12;725;737
17;Girona;3;Girona;2;Alt Empordà;17062;Escala, l';1;5;;1383;425;613;736;647;12;17;707;724
8;Barcelona;1;Barcelona;11;Baix Llobregat;08076;Esparreguera;1;1;;1903;633;878;1120;783;8;2;1110;1112
8;Barcelona;1;Barcelona;11;Baix Llobregat;08076;Esparreguera;1;2;;1554;528;768;996;558;5;10;981;991
8;Barcelona;1;Barcelona;11;Baix Llobregat;08076;Esparreguera;1;3;;1393;491;741;974;419;3;8;963;971
8;Barcelona;1;Barcelona;11;Baix Llobregat;08076;Esparreguera;1;4;;1906;627;938;1223;683;8;21;1194;1215
8;Barcelona;1;Barcelona;11;Baix Llobregat;08076;Esparreguera;1;5;;681;200;309;375;306;2;5;368;373
8;Barcelona;1;Barcelona;11;Baix Llobregat;08076;Esparreguera;1;6;;1381;453;675;923;458;4;8;911;919
8;Barcelona;1;Barcelona;11;Baix Llobregat;08076;Esparreguera;2;1;;1810;586;791;1034;776;4;3;1027;1030
8;Barcelona;1;Barcelona;11;Baix Llobregat;08076;Esparreguera;2;2;;1340;408;593;783;557;2;6;775;781
8;Barcelona;1;Barcelona;11;Baix Llobregat;08076;Esparreguera;2;3;;1566;583;848;1081;485;3;8;1070;1078
8;Barcelona;1;Barcelona;11;Baix Llobregat;08076;Esparreguera;2;4;;1530;508;707;917;613;7;1;909;910
8;Barcelona;1;Barcelona;11;Baix Llobregat;08076;Esparreguera;2;5;;1513;394;553;709;804;5;3;701;704
17;Girona;2;Catalunya Central;24;Osona;17063;Espinelves;1;1;;174;91;134;158;16;2;13;143;156
25;Lleida;4;Lleida;18;Garrigues;25081;Espluga Calba, l';1;1;;285;122;161;196;89;20;40;136;176
43;Tarragona;6;Camp de Tarragona;16;Conca de Barberà;43054;Espluga de Francolí, l';1;1;;1644;688;943;1210;434;9;23;1178;1201
43;Tarragona;6;Camp de Tarragona;16;Conca de Barberà;43054;Espluga de Francolí, l';2;1;;1177;489;662;885;292;14;15;856;871
8;Barcelona;1;Barcelona;11;Baix Llobregat;08077;Esplugues de Llobregat;1;1;;1810;630;885;1278;532;2;7;1269;1276
8;Barcelona;1;Barcelona;11;Baix Llobregat;08077;Esplugues de Llobregat;1;2;;982;359;512;680;302;1;7;672;679
8;Barcelona;1;Barcelona;11;Baix Llobregat;08077;Esplugues de Llobregat;1;3;;1250;504;675;897;353;2;12;883;895
8;Barcelona;1;Barcelona;11;Baix Llobregat;08077;Esplugues de Llobregat;1;4;;1099;366;524;678;421;6;2;670;672
8;Barcelona;1;Barcelona;11;Baix Llobregat;08077;Esplugues de Llobregat;1;5;;1317;486;686;914;403;3;9;902;911
8;Barcelona;1;Barcelona;11;Baix Llobregat;08077;Esplugues de Llobregat;10;1;;1580;634;844;1058;522;3;3;1052;1055
8;Barcelona;1;Barcelona;11;Baix Llobregat;08077;Esplugues de Llobregat;10;2;;1133;422;607;753;380;1;2;750;752
8;Barcelona;1;Barcelona;11;Baix Llobregat;08077;Esplugues de Llobregat;10;3;;1658;595;799;1005;653;8;4;993;997
8;Barcelona;1;Barcelona;11;Baix Llobregat;08077;Esplugues de Llobregat;10;4;;916;288;368;452;464;2;2;448;450
8;Barcelona;1;Barcelona;11;Baix Llobregat;08077;Esplugues de Llobregat;10;5;;852;270;361;449;403;0;1;448;449
8;Barcelona;1;Barcelona;11;Baix Llobregat;08077;Esplugues de Llobregat;10;6;;1229;459;613;753;476;0;6;747;753
8;Barcelona;1;Barcelona;11;Baix Llobregat;08077;Esplugues de Llobregat;10;7;;1213;433;616;761;452;0;3;758;761
8;Barcelona;1;Barcelona;11;Baix Llobregat;08077;Esplugues de Llobregat;10;8;;1407;370;535;679;728;2;4;673;677
8;Barcelona;1;Barcelona;11;Baix Llobregat;08077;Esplugues de Llobregat;2;1;;1125;400;551;750;375;4;12;734;746
8;Barcelona;1;Barcelona;11;Baix Llobregat;08077;Esplugues de Llobregat;2;2;;1050;338;483;640;410;2;2;636;638
8;Barcelona;1;Barcelona;11;Baix Llobregat;08077;Esplugues de Llobregat;2;3;;1302;446;645;828;474;3;5;820;825
8;Barcelona;1;Barcelona;11;Baix Llobregat;08077;Esplugues de Llobregat;2;4;;1167;401;569;733;434;1;3;729;732
8;Barcelona;1;Barcelona;11;Baix Llobregat;08077;Esplugues de Llobregat;2;5;;1257;461;609;787;470;1;8;778;786
8;Barcelona;1;Barcelona;11;Baix Llobregat;08077;Esplugues de Llobregat;2;6;;1380;451;683;926;454;2;10;914;924
8;Barcelona;1;Barcelona;11;Baix Llobregat;08077;Esplugues de Llobregat;3;1;;1157;421;583;777;380;2;7;768;775
8;Barcelona;1;Barcelona;11;Baix Llobregat;08077;Esplugues de Llobregat;3;2;;1658;602;880;1126;532;2;2;1122;1124
8;Barcelona;1;Barcelona;11;Baix Llobregat;08077;Esplugues de Llobregat;4;1;;572;176;262;387;185;0;9;378;387
8;Barcelona;1;Barcelona;11;Baix Llobregat;08077;Esplugues de Llobregat;5;1;;596;120;190;281;315;1;4;276;280
8;Barcelona;1;Barcelona;11;Baix Llobregat;08077;Esplugues de Llobregat;6;1;;585;175;254;349;236;3;1;345;346
8;Barcelona;1;Barcelona;11;Baix Llobregat;08077;Esplugues de Llobregat;7;1;;826;245;384;550;276;1;2;547;549
8;Barcelona;1;Barcelona;11;Baix Llobregat;08077;Esplugues de Llobregat;8;1;;1539;578;810;1043;496;6;10;1027;1037
8;Barcelona;1;Barcelona;11;Baix Llobregat;08077;Esplugues de Llobregat;8;2;;1653;566;825;1062;591;3;10;1049;1059
8;Barcelona;1;Barcelona;11;Baix Llobregat;08077;Esplugues de Llobregat;9;1;;1245;431;579;799;446;1;4;794;798
8;Barcelona;1;Barcelona;11;Baix Llobregat;08077;Esplugues de Llobregat;9;2;;1481;499;738;1001;480;7;8;986;994
17;Girona;3;Girona;2;Alt Empordà;17064;Espolla;1;1;;335;143;196;252;83;8;14;230;244
17;Girona;3;Girona;28;Pla de l'Estany;17065;Esponellà;1;1;;332;164;225;281;51;3;4;274;278
25;Lleida;5;Alt Pirineu i territori d'Aran;26;Pallars Sobirà;25082;Espot;1;1;;296;125;189;257;39;7;5;245;250
8;Barcelona;2;Catalunya Central;14;Berguedà;08078;Espunyola, l';1;1;;220;65;125;181;39;3;6;172;178
8;Barcelona;2;Catalunya Central;24;Osona;08254;Esquirol, l';1;1;;1770;711;1023;1379;391;46;123;1210;1333
25;Lleida;5;Alt Pirineu i territori d'Aran;4;Alt Urgell;25088;Estamariu;1;1;;96;52;65;83;13;1;2;80;82
8;Barcelona;2;Catalunya Central;42;Moianès;08079;Estany, l';1;1;;333;160;245;283;50;4;17;262;279
25;Lleida;4;Lleida;32;Segarra;25085;Estaràs;1;1;;141;63;90;110;31;6;2;102;104
25;Lleida;5;Alt Pirineu i territori d'Aran;26;Pallars Sobirà;25086;Esterri d'Àneu;1;1;;528;213;290;418;110;10;24;384;408
25;Lleida;5;Alt Pirineu i territori d'Aran;26;Pallars Sobirà;25087;Esterri de Cardós;1;1;;56;19;32;49;7;0;0;49;49
43;Tarragona;6;Camp de Tarragona;29;Priorat;43055;Falset;1;1;;803;393;522;657;146;16;16;625;641
43;Tarragona;6;Camp de Tarragona;29;Priorat;43055;Falset;2;1;;1204;520;725;949;255;10;46;893;939
17;Girona;3;Girona;2;Alt Empordà;17005;Far d'Empordà, el;1;1;;466;206;327;384;82;0;10;374;384
25;Lleida;5;Alt Pirineu i territori d'Aran;26;Pallars Sobirà;25089;Farrera;1;1;;97;29;37;79;18;0;0;79;79
43;Tarragona;7;Terres de l'Ebre;37;Terra Alta;43056;Fatarella, la;1;1;;806;307;477;633;173;17;29;587;616
43;Tarragona;6;Camp de Tarragona;8;Baix Camp;43057;Febró, la;1;1;;38;15;24;35;3;2;4;29;33
8;Barcelona;1;Barcelona;41;Vallès Oriental;08134;Figaró-Montmany;1;1;;848;346;467;572;276;6;23;543;566
8;Barcelona;2;Catalunya Central;14;Berguedà;08080;Fígols;1;1;;41;24;34;39;2;0;0;39;39
25;Lleida;5;Alt Pirineu i territori d'Aran;4;Alt Urgell;25908;Fígols i Alinyà;1;1;;217;101;158;186;31;2;7;177;184
43;Tarragona;6;Camp de Tarragona;29;Priorat;43058;Figuera, la;1;1;;109;49;61;86;23;5;6;75;81
17;Girona;3;Girona;2;Alt Empordà;17066;Figueres;1;1;;708;263;345;423;285;0;6;417;423
17;Girona;3;Girona;2;Alt Empordà;17066;Figueres;1;2;;881;336;460;580;301;1;5;574;579
17;Girona;3;Girona;2;Alt Empordà;17066;Figueres;1;3;;1777;619;871;1054;723;2;12;1040;1052
17;Girona;3;Girona;2;Alt Empordà;17066;Figueres;1;4;;806;296;392;469;337;3;3;463;466
17;Girona;3;Girona;2;Alt Empordà;17066;Figueres;1;5;;830;183;322;387;443;2;1;384;385
17;Girona;3;Girona;2;Alt Empordà;17066;Figueres;1;6;;1352;414;576;674;678;4;4;666;670
17;Girona;3;Girona;2;Alt Empordà;17066;Figueres;1;7;;1022;323;432;530;492;1;2;527;529
17;Girona;3;Girona;2;Alt Empordà;17066;Figueres;1;8;;668;225;300;355;313;0;1;354;355
17;Girona;3;Girona;2;Alt Empordà;17066;Figueres;2;1;;667;231;303;379;288;1;3;375;378
17;Girona;3;Girona;2;Alt Empordà;17066;Figueres;2;2;;1005;332;494;586;419;4;3;579;582
17;Girona;3;Girona;2;Alt Empordà;17066;Figueres;2;3;;802;311;419;537;265;1;5;531;536
17;Girona;3;Girona;2;Alt Empordà;17066;Figueres;2;4;;1565;545;742;897;668;7;8;882;890
17;Girona;3;Girona;2;Alt Empordà;17066;Figueres;3;1;;1076;329;461;588;488;6;3;579;582
17;Girona;3;Girona;2;Alt Empordà;17066;Figueres;3;2;;1307;450;612;756;551;0;8;748;756
17;Girona;3;Girona;2;Alt Empordà;17066;Figueres;3;3;;1593;526;738;893;700;6;6;881;887
17;Girona;3;Girona;2;Alt Empordà;17066;Figueres;3;4;;774;193;284;362;412;3;1;358;359
17;Girona;3;Girona;2;Alt Empordà;17066;Figueres;3;5;;1693;580;796;978;715;1;7;970;977
17;Girona;3;Girona;2;Alt Empordà;17066;Figueres;4;1;;914;250;392;510;404;4;1;505;506
17;Girona;3;Girona;2;Alt Empordà;17066;Figueres;4;2;;1348;510;681;832;516;3;5;824;829
17;Girona;3;Girona;2;Alt Empordà;17066;Figueres;4;3;;1440;415;627;791;649;1;6;784;790
17;Girona;3;Girona;2;Alt Empordà;17066;Figueres;4;4;;1812;626;923;1090;722;5;16;1069;1085
17;Girona;3;Girona;2;Alt Empordà;17066;Figueres;4;5;;1137;359;485;570;567;2;2;566;568
17;Girona;3;Girona;2;Alt Empordà;17066;Figueres;4;7;;696;233;376;461;235;1;1;459;460
17;Girona;3;Girona;2;Alt Empordà;17066;Figueres;4;8;;761;233;350;435;326;2;1;432;433
17;Girona;3;Girona;2;Alt Empordà;17066;Figueres;4;9;;990;330;517;626;364;1;7;618;625
43;Tarragona;6;Camp de Tarragona;1;Alt Camp;43059;Figuerola del Camp;1;1;;253;106;150;187;66;17;32;138;170
17;Girona;3;Girona;20;Gironès;17067;Flaçà;1;1;;714;336;478;556;158;4;19;533;552
43;Tarragona;7;Terres de l'Ebre;30;Ribera d'Ebre;43060;Flix;1;1;;815;373;501;639;176;19;10;610;620
43;Tarragona;7;Terres de l'Ebre;30;Ribera d'Ebre;43060;Flix;1;2;;1043;500;653;794;249;15;11;768;779
43;Tarragona;7;Terres de l'Ebre;30;Ribera d'Ebre;43060;Flix;2;1;;852;351;493;625;227;17;16;592;608
25;Lleida;4;Lleida;18;Garrigues;25092;Floresta, la;1;1;;126;63;81;102;24;1;2;99;101
8;Barcelona;3;Girona;34;Selva;08082;Fogars de la Selva;1;1;;1166;363;698;728;438;9;19;700;719
8;Barcelona;1;Barcelona;41;Vallès Oriental;08081;Fogars de Montclús;1;1;;357;162;234;291;66;4;13;274;287
17;Girona;3;Girona;10;Baix Empordà;17068;Foixà;1;1;;251;94;143;186;65;15;10;161;171
8;Barcelona;2;Catalunya Central;24;Osona;08083;Folgueroles;1;1;;1670;728;1118;1407;263;8;36;1363;1399
25;Lleida;4;Lleida;27;Pla d'Urgell;25093;Fondarella;1;1;;631;287;403;478;153;5;8;465;473
8;Barcelona;2;Catalunya Central;7;Bages;08084;Fonollosa;1;1;;1166;402;580;789;377;15;105;669;774
17;Girona;5;Alt Pirineu i territori d'Aran;15;Cerdanya;17069;Fontanals de Cerdanya;1;1;;368;134;169;247;121;9;23;215;238
17;Girona;3;Girona;10;Baix Empordà;17070;Fontanilles;1;1;;113;54;70;87;26;2;8;77;85
17;Girona;3;Girona;28;Pla de l'Estany;17071;Fontcoberta;1;1;;1137;525;750;908;229;5;31;872;903
8;Barcelona;8;Penedès;3;Alt Penedès;08085;Font-rubí;1;1;;990;379;586;760;230;18;11;731;742
25;Lleida;4;Lleida;23;Noguera;25094;Foradada;1;1;;147;63;89;115;32;6;3;106;109
17;Girona;3;Girona;10;Baix Empordà;17902;Forallac;1;1;;752;316;454;566;186;7;22;537;559
17;Girona;3;Girona;10;Baix Empordà;17902;Forallac;1;2;;597;261;380;473;124;5;5;463;468
43;Tarragona;6;Camp de Tarragona;16;Conca de Barberà;43061;Forès;1;1;;40;20;26;35;5;1;4;30;34
17;Girona;3;Girona;20;Gironès;17073;Fornells de la Selva;1;1;;1945;856;1258;1575;370;7;33;1535;1568
17;Girona;3;Girona;2;Alt Empordà;17074;Fortià;1;1;;549;249;355;421;128;11;7;403;410
8;Barcelona;1;Barcelona;41;Vallès Oriental;08086;Franqueses del Vallès, les;1;1;;1688;594;878;1108;580;5;8;1095;1103
8;Barcelona;1;Barcelona;41;Vallès Oriental;08086;Franqueses del Vallès, les;1;10;;592;175;276;347;245;1;5;341;346
8;Barcelona;1;Barcelona;41;Vallès Oriental;08086;Franqueses del Vallès, les;1;2;;1577;456;619;790;787;1;4;785;789
8;Barcelona;1;Barcelona;41;Vallès Oriental;08086;Franqueses del Vallès, les;1;3;;1087;274;381;488;599;4;3;481;484
8;Barcelona;1;Barcelona;41;Vallès Oriental;08086;Franqueses del Vallès, les;1;4;;1084;345;475;629;455;2;6;621;627
8;Barcelona;1;Barcelona;41;Vallès Oriental;08086;Franqueses del Vallès, les;1;5;;1434;466;698;863;571;0;6;857;863
8;Barcelona;1;Barcelona;41;Vallès Oriental;08086;Franqueses del Vallès, les;1;6;;1400;536;759;956;444;4;5;947;952
8;Barcelona;1;Barcelona;41;Vallès Oriental;08086;Franqueses del Vallès, les;1;7;;1283;357;552;773;510;2;4;767;771
8;Barcelona;1;Barcelona;41;Vallès Oriental;08086;Franqueses del Vallès, les;1;8;;1032;261;389;524;508;8;5;511;516
8;Barcelona;1;Barcelona;41;Vallès Oriental;08086;Franqueses del Vallès, les;1;9;;1099;337;510;676;423;4;10;662;672
8;Barcelona;1;Barcelona;41;Vallès Oriental;08086;Franqueses del Vallès, les;2;1;;1806;660;1004;1257;549;3;5;1249;1254
43;Tarragona;7;Terres de l'Ebre;22;Montsià;43062;Freginals;1;1;;293;149;191;236;57;8;8;220;228
25;Lleida;4;Lleida;38;Urgell;25096;Fuliola, la;1;1;;888;405;565;714;174;20;16;678;694
25;Lleida;4;Lleida;18;Garrigues;25097;Fulleda;1;1;;86;32;56;74;12;1;4;69;73
8;Barcelona;2;Catalunya Central;7;Bages;08090;Gaià;1;1;;138;60;87;120;18;0;3;117;120
43;Tarragona;7;Terres de l'Ebre;22;Montsià;43063;Galera, la;1;1;;594;273;391;475;119;21;10;444;454
8;Barcelona;1;Barcelona;40;Vallès Occidental;08087;Gallifa;1;1;;147;84;109;131;16;0;4;127;131
43;Tarragona;7;Terres de l'Ebre;37;Terra Alta;43064;Gandesa;1;1;;1255;508;733;946;309;18;24;904;928
43;Tarragona;7;Terres de l'Ebre;37;Terra Alta;43064;Gandesa;2;1;;853;397;564;687;166;19;14;654;668
43;Tarragona;7;Terres de l'Ebre;30;Ribera d'Ebre;43065;Garcia;1;1;;396;151;218;302;94;12;14;276;290
43;Tarragona;6;Camp de Tarragona;1;Alt Camp;43066;Garidells, els;1;1;;155;59;89;120;35;7;3;110;113
8;Barcelona;1;Barcelona;41;Vallès Oriental;08088;Garriga, la;1;1;;1786;697;991;1239;547;8;14;1217;1231
8;Barcelona;1;Barcelona;41;Vallès Oriental;08088;Garriga, la;1;2;;1528;493;805;1025;503;6;15;1004;1019
8;Barcelona;1;Barcelona;41;Vallès Oriental;08088;Garriga, la;1;3;;844;272;415;542;302;2;3;537;540
8;Barcelona;1;Barcelona;41;Vallès Oriental;08088;Garriga, la;1;4;;1234;443;662;856;378;1;12;843;855
8;Barcelona;1;Barcelona;41;Vallès Oriental;08088;Garriga, la;2;1;;793;307;436;572;221;1;11;560;571
8;Barcelona;1;Barcelona;41;Vallès Oriental;08088;Garriga, la;2;2;;1506;580;707;1033;473;3;13;1017;1030
8;Barcelona;1;Barcelona;41;Vallès Oriental;08088;Garriga, la;2;3;;1941;727;1060;1354;587;8;10;1336;1346
8;Barcelona;1;Barcelona;41;Vallès Oriental;08088;Garriga, la;2;4;;670;232;330;447;223;7;4;436;440
8;Barcelona;1;Barcelona;41;Vallès Oriental;08088;Garriga, la;2;5;;1419;494;783;1031;388;8;3;1020;1023
8;Barcelona;1;Barcelona;41;Vallès Oriental;08088;Garriga, la;2;6;;631;229;317;408;223;0;2;406;408
17;Girona;3;Girona;2;Alt Empordà;17075;Garrigàs;1;1;;339;141;210;245;94;3;54;188;242
17;Girona;3;Girona;10;Baix Empordà;17076;Garrigoles;1;1;;128;65;86;105;23;2;5;98;103
17;Girona;3;Girona;2;Alt Empordà;17077;Garriguella;1;1;;605;299;444;521;84;8;15;498;513
8;Barcelona;1;Barcelona;11;Baix Llobregat;08089;Gavà;1;1;;1348;487;685;867;481;1;3;863;866
8;Barcelona;1;Barcelona;11;Baix Llobregat;08089;Gavà;1;2;;1247;490;679;867;380;1;5;861;866
8;Barcelona;1;Barcelona;11;Baix Llobregat;08089;Gavà;1;3;;1437;597;775;939;498;6;11;922;933
8;Barcelona;1;Barcelona;11;Baix Llobregat;08089;Gavà;1;4;;1400;503;728;895;505;8;3;884;887
8;Barcelona;1;Barcelona;11;Baix Llobregat;08089;Gavà;1;5;;959;344;437;533;426;3;2;528;530
8;Barcelona;1;Barcelona;11;Baix Llobregat;08089;Gavà;1;6;;818;281;378;488;330;1;1;486;487
8;Barcelona;1;Barcelona;11;Baix Llobregat;08089;Gavà;1;7;;1544;428;627;851;693;1;3;847;850
8;Barcelona;1;Barcelona;11;Baix Llobregat;08089;Gavà;1;8;;1609;414;670;1006;603;2;13;991;1004
8;Barcelona;1;Barcelona;11;Baix Llobregat;08089;Gavà;2;1;;1662;607;866;1089;573;4;5;1080;1085
8;Barcelona;1;Barcelona;11;Baix Llobregat;08089;Gavà;2;10;;687;193;290;408;279;0;1;407;408
8;Barcelona;1;Barcelona;11;Baix Llobregat;08089;Gavà;2;2;;855;330;444;558;297;2;2;554;556
8;Barcelona;1;Barcelona;11;Baix Llobregat;08089;Gavà;2;3;;779;276;406;516;263;2;5;509;514
8;Barcelona;1;Barcelona;11;Baix Llobregat;08089;Gavà;2;4;;1347;467;616;766;581;3;6;757;763
8;Barcelona;1;Barcelona;11;Baix Llobregat;08089;Gavà;2;5;;890;211;359;459;431;1;3;455;458
8;Barcelona;1;Barcelona;11;Baix Llobregat;08089;Gavà;2;6;;1313;427;576;701;612;4;1;696;697
8;Barcelona;1;Barcelona;11;Baix Llobregat;08089;Gavà;2;7;;742;237;336;445;297;4;0;441;441
8;Barcelona;1;Barcelona;11;Baix Llobregat;08089;Gavà;2;8;;1261;471;649;818;443;2;4;812;816
8;Barcelona;1;Barcelona;11;Baix Llobregat;08089;Gavà;2;9;;1360;461;625;816;544;3;6;807;813
8;Barcelona;1;Barcelona;11;Baix Llobregat;08089;Gavà;3;1;;932;346;426;565;367;3;3;559;562
8;Barcelona;1;Barcelona;11;Baix Llobregat;08089;Gavà;3;2;;897;338;432;535;362;2;4;529;533
8;Barcelona;1;Barcelona;11;Baix Llobregat;08089;Gavà;3;3;;1688;557;767;1048;640;0;7;1041;1048
8;Barcelona;1;Barcelona;11;Baix Llobregat;08089;Gavà;3;4;;1192;366;475;612;580;4;0;608;608
8;Barcelona;1;Barcelona;11;Baix Llobregat;08089;Gavà;3;5;;1474;368;565;723;751;2;6;715;721
8;Barcelona;1;Barcelona;11;Baix Llobregat;08089;Gavà;3;6;;918;319;455;568;350;2;4;562;566
8;Barcelona;1;Barcelona;11;Baix Llobregat;08089;Gavà;3;7;;760;280;387;517;243;3;4;510;514
8;Barcelona;1;Barcelona;11;Baix Llobregat;08089;Gavà;3;8;;2117;671;1007;1345;772;5;6;1334;1340
8;Barcelona;1;Barcelona;11;Baix Llobregat;08089;Gavà;4;1;;1816;639;889;1153;663;1;8;1144;1152
8;Barcelona;1;Barcelona;11;Baix Llobregat;08089;Gavà;4;2;;1248;402;595;729;519;2;2;725;727
25;Lleida;5;Alt Pirineu i territori d'Aran;25;Pallars Jussà;25098;Gavet de la Conca;1;1;;246;100;147;186;60;2;7;177;184
8;Barcelona;8;Penedès;3;Alt Penedès;08091;Gelida;1;1;;1798;645;923;1195;603;2;9;1184;1193
8;Barcelona;8;Penedès;3;Alt Penedès;08091;Gelida;1;2;;1726;671;952;1224;502;3;5;1216;1221
8;Barcelona;8;Penedès;3;Alt Penedès;08091;Gelida;2;1;;1943;755;1067;1330;613;7;8;1315;1323
17;Girona;5;Alt Pirineu i territori d'Aran;15;Cerdanya;17078;Ger;1;1;;344;124;195;263;81;4;13;246;259
25;Lleida;4;Lleida;33;Segrià;25912;Gimenells i el Pla de la Font;1;1;;855;405;554;691;164;10;10;671;681
43;Tarragona;7;Terres de l'Ebre;30;Ribera d'Ebre;43067;Ginestar;1;1;;575;247;343;425;150;67;68;290;358
17;Girona;3;Girona;20;Gironès;17079;Girona;1;1;;791;274;414;531;260;0;5;526;531
17;Girona;3;Girona;20;Gironès;17079;Girona;1;2;;659;238;319;448;211;1;2;445;447
17;Girona;3;Girona;20;Gironès;17079;Girona;1;3;;903;317;466;632;271;4;4;624;628
17;Girona;3;Girona;20;Gironès;17079;Girona;1;4;;826;259;358;462;364;1;4;457;461
17;Girona;3;Girona;20;Gironès;17079;Girona;1;5;;1018;167;289;401;617;3;0;398;398
17;Girona;3;Girona;20;Gironès;17079;Girona;1;6;;1000;316;432;502;498;2;1;499;500
17;Girona;3;Girona;20;Gironès;17079;Girona;2;1;;583;249;333;450;133;0;3;447;450
17;Girona;3;Girona;20;Gironès;17079;Girona;2;10;;1694;598;925;1172;522;7;9;1156;1165
17;Girona;3;Girona;20;Gironès;17079;Girona;2;11;;1545;466;747;941;604;6;5;930;935
17;Girona;3;Girona;20;Gironès;17079;Girona;2;12;;1007;438;582;744;263;4;8;732;740
17;Girona;3;Girona;20;Gironès;17079;Girona;2;13;;776;297;391;543;233;2;6;535;541
17;Girona;3;Girona;20;Gironès;17079;Girona;2;14;;682;220;327;406;276;2;1;403;404
17;Girona;3;Girona;20;Gironès;17079;Girona;2;15;;1861;687;963;1309;552;1;14;1294;1308
17;Girona;3;Girona;20;Gironès;17079;Girona;2;16;;1006;416;579;775;231;2;0;773;773
17;Girona;3;Girona;20;Gironès;17079;Girona;2;17;;1009;406;600;766;243;2;4;760;764
17;Girona;3;Girona;20;Gironès;17079;Girona;2;18;;1114;499;652;834;280;3;2;829;831
17;Girona;3;Girona;20;Gironès;17079;Girona;2;19;;1793;690;985;1341;452;3;4;1334;1338
17;Girona;3;Girona;20;Gironès;17079;Girona;2;2;;683;262;346;451;232;0;2;449;451
17;Girona;3;Girona;20;Gironès;17079;Girona;2;20;;900;310;450;605;295;5;6;594;600
17;Girona;3;Girona;20;Gironès;17079;Girona;2;21;;1060;438;598;761;299;0;8;753;761
17;Girona;3;Girona;20;Gironès;17079;Girona;2;22;;984;274;425;582;402;1;2;579;581
17;Girona;3;Girona;20;Gironès;17079;Girona;2;3;;947;347;511;682;265;2;4;676;680
17;Girona;3;Girona;20;Gironès;17079;Girona;2;4;;1244;488;689;891;353;1;8;882;890
17;Girona;3;Girona;20;Gironès;17079;Girona;2;5;;735;276;387;499;236;1;4;494;498
17;Girona;3;Girona;20;Gironès;17079;Girona;2;6;;1436;583;782;982;454;0;7;975;982
17;Girona;3;Girona;20;Gironès;17079;Girona;2;7;;1273;522;689;924;349;5;4;915;919
17;Girona;3;Girona;20;Gironès;17079;Girona;2;8;;1533;634;870;1139;394;1;3;1135;1138
17;Girona;3;Girona;20;Gironès;17079;Girona;2;9;;1053;370;522;702;351;0;5;697;702
17;Girona;3;Girona;20;Gironès;17079;Girona;3;1;;733;301;394;520;213;3;4;513;517
17;Girona;3;Girona;20;Gironès;17079;Girona;3;10;;1232;438;571;688;544;1;3;684;687
17;Girona;3;Girona;20;Gironès;17079;Girona;3;11;;1630;538;729;901;729;6;8;887;895
17;Girona;3;Girona;20;Gironès;17079;Girona;3;12;;1543;526;721;875;668;6;7;862;869
17;Girona;3;Girona;20;Gironès;17079;Girona;3;13;;923;286;405;499;424;3;3;493;496
17;Girona;3;Girona;20;Gironès;17079;Girona;3;14;;1301;412;536;670;631;5;2;663;665
17;Girona;3;Girona;20;Gironès;17079;Girona;3;15;;1137;446;556;707;430;3;2;702;704
17;Girona;3;Girona;20;Gironès;17079;Girona;3;16;;1074;414;563;711;363;1;4;706;710
17;Girona;3;Girona;20;Gironès;17079;Girona;3;17;;1279;384;586;741;538;6;1;734;735
17;Girona;3;Girona;20;Gironès;17079;Girona;3;18;;1164;355;516;655;509;3;2;650;652
17;Girona;3;Girona;20;Gironès;17079;Girona;3;19;;1187;464;660;875;312;1;7;867;874
17;Girona;3;Girona;20;Gironès;17079;Girona;3;2;;804;304;429;586;218;3;3;580;583
17;Girona;3;Girona;20;Gironès;17079;Girona;3;20;;993;390;587;746;247;3;2;741;743
17;Girona;3;Girona;20;Gironès;17079;Girona;3;3;;1565;565;872;1075;490;3;14;1058;1072
17;Girona;3;Girona;20;Gironès;17079;Girona;3;4;;858;353;532;659;199;3;0;656;656
17;Girona;3;Girona;20;Gironès;17079;Girona;3;5;;1077;471;664;854;223;4;7;843;850
17;Girona;3;Girona;20;Gironès;17079;Girona;3;6;;707;299;410;510;197;0;1;509;510
17;Girona;3;Girona;20;Gironès;17079;Girona;3;7;;1305;458;586;742;563;0;0;742;742
17;Girona;3;Girona;20;Gironès;17079;Girona;3;8;;1880;585;852;1115;765;3;3;1109;1112
17;Girona;3;Girona;20;Gironès;17079;Girona;3;9;;799;237;324;386;413;5;3;378;381
17;Girona;3;Girona;20;Gironès;17079;Girona;4;1;;865;315;399;464;401;1;3;460;463
17;Girona;3;Girona;20;Gironès;17079;Girona;4;2;;601;210;285;366;235;0;1;365;366
17;Girona;3;Girona;20;Gironès;17079;Girona;5;1;;1165;473;693;938;227;1;5;932;937
17;Girona;3;Girona;20;Gironès;17079;Girona;5;2;;597;213;290;357;240;2;3;352;355
17;Girona;3;Girona;20;Gironès;17079;Girona;5;3;;1197;390;545;645;552;9;3;633;636
17;Girona;3;Girona;20;Gironès;17079;Girona;5;4;;641;307;395;482;159;3;1;478;479
17;Girona;3;Girona;20;Gironès;17079;Girona;5;5;;754;261;364;428;326;5;2;421;423
17;Girona;3;Girona;20;Gironès;17079;Girona;5;6;;959;354;521;721;238;0;1;720;721
17;Girona;3;Girona;20;Gironès;17079;Girona;6;1;;1506;565;803;1005;501;5;7;993;1000
17;Girona;3;Girona;20;Gironès;17079;Girona;6;2;;1827;668;881;1081;746;2;5;1074;1079
17;Girona;3;Girona;20;Gironès;17079;Girona;6;3;;1514;491;723;899;615;3;8;888;896
17;Girona;3;Girona;20;Gironès;17079;Girona;6;4;;1214;418;625;799;415;1;3;795;798
17;Girona;3;Girona;20;Gironès;17079;Girona;6;5;;748;234;309;373;375;1;0;372;372
8;Barcelona;2;Catalunya Central;14;Berguedà;08092;Gironella;1;1;;1247;529;772;956;291;9;26;921;947
8;Barcelona;2;Catalunya Central;14;Berguedà;08092;Gironella;2;1;;341;141;187;227;114;5;5;217;222
8;Barcelona;2;Catalunya Central;14;Berguedà;08092;Gironella;2;2;;1072;427;644;785;287;9;14;762;776
8;Barcelona;2;Catalunya Central;14;Berguedà;08092;Gironella;2;3;;1060;410;607;769;291;9;15;745;760
8;Barcelona;2;Catalunya Central;14;Berguedà;08093;Gisclareny;1;1;;24;17;17;22;2;0;2;20;22
43;Tarragona;7;Terres de l'Ebre;22;Montsià;43068;Godall;1;1;;530;269;375;461;69;7;2;452;454
25;Lleida;4;Lleida;27;Pla d'Urgell;25099;Golmés;1;1;;1321;611;852;1010;311;19;32;959;991
17;Girona;3;Girona;31;Ripollès;17080;Gombrèn;1;1;;147;55;94;129;18;0;2;127;129
25;Lleida;2;Catalunya Central;14;Berguedà;25100;Gósol;1;1;;185;70;111;147;38;3;4;140;144
8;Barcelona;8;Penedès;3;Alt Penedès;08094;Granada, la;1;1;;1600;604;928;1190;410;12;31;1147;1178
25;Lleida;4;Lleida;18;Garrigues;25101;Granadella, la;1;1;;561;305;427;499;62;9;7;483;490
8;Barcelona;1;Barcelona;42;Moianès;08095;Granera;1;1;;67;36;43;58;9;4;1;53;54
25;Lleida;4;Lleida;33;Segrià;25102;Granja d'Escarp, la;1;1;;665;260;364;448;217;19;33;396;429
8;Barcelona;1;Barcelona;41;Vallès Oriental;08096;Granollers;1;1;;1691;647;939;1187;504;10;8;1169;1177
8;Barcelona;1;Barcelona;41;Vallès Oriental;08096;Granollers;1;10;;1174;389;525;689;485;2;6;681;687
8;Barcelona;1;Barcelona;41;Vallès Oriental;08096;Granollers;1;11;;1258;422;569;692;566;3;4;685;689
8;Barcelona;1;Barcelona;41;Vallès Oriental;08096;Granollers;1;3;;1382;547;740;927;455;1;7;919;926
8;Barcelona;1;Barcelona;41;Vallès Oriental;08096;Granollers;1;4;;1939;785;1102;1353;586;4;6;1343;1349
8;Barcelona;1;Barcelona;41;Vallès Oriental;08096;Granollers;1;5;;1427;539;787;990;437;1;3;986;989
8;Barcelona;1;Barcelona;41;Vallès Oriental;08096;Granollers;1;6;;808;242;341;404;404;0;2;402;404
8;Barcelona;1;Barcelona;41;Vallès Oriental;08096;Granollers;1;9;;1486;428;627;764;722;1;2;761;763
8;Barcelona;1;Barcelona;41;Vallès Oriental;08096;Granollers;2;1;;1532;580;830;1025;507;3;10;1012;1022
8;Barcelona;1;Barcelona;41;Vallès Oriental;08096;Granollers;2;2;;1044;415;581;744;300;2;9;733;742
8;Barcelona;1;Barcelona;41;Vallès Oriental;08096;Granollers;2;3;;544;212;312;388;156;2;4;382;386
8;Barcelona;1;Barcelona;41;Vallès Oriental;08096;Granollers;2;4;;1265;471;617;751;514;4;0;747;747
8;Barcelona;1;Barcelona;41;Vallès Oriental;08096;Granollers;2;5;;1166;376;570;726;440;1;6;719;725
8;Barcelona;1;Barcelona;41;Vallès Oriental;08096;Granollers;2;6;;1424;535;735;934;490;4;9;921;930
8;Barcelona;1;Barcelona;41;Vallès Oriental;08096;Granollers;2;7;;1035;315;469;615;420;0;3;612;615
8;Barcelona;1;Barcelona;41;Vallès Oriental;08096;Granollers;3;1;;1714;653;980;1180;534;2;2;1176;1178
8;Barcelona;1;Barcelona;41;Vallès Oriental;08096;Granollers;3;10;;1009;332;470;581;428;1;4;576;580
8;Barcelona;1;Barcelona;41;Vallès Oriental;08096;Granollers;3;2;;1434;474;668;860;574;1;2;857;859
8;Barcelona;1;Barcelona;41;Vallès Oriental;08096;Granollers;3;3;;1069;307;445;588;481;3;4;581;585
8;Barcelona;1;Barcelona;41;Vallès Oriental;08096;Granollers;3;4;;1448;452;749;954;494;3;5;946;951
8;Barcelona;1;Barcelona;41;Vallès Oriental;08096;Granollers;3;5;;1317;469;748;862;455;2;2;858;860
8;Barcelona;1;Barcelona;41;Vallès Oriental;08096;Granollers;3;6;;1059;376;587;703;356;3;2;698;700
8;Barcelona;1;Barcelona;41;Vallès Oriental;08096;Granollers;3;7;;725;207;299;369;356;0;2;367;369
8;Barcelona;1;Barcelona;41;Vallès Oriental;08096;Granollers;3;8;;904;270;406;490;414;0;1;489;490
8;Barcelona;1;Barcelona;41;Vallès Oriental;08096;Granollers;3;9;;794;285;409;555;239;3;4;548;552
8;Barcelona;1;Barcelona;41;Vallès Oriental;08096;Granollers;4;1;;1717;669;938;1163;554;5;12;1146;1158
8;Barcelona;1;Barcelona;41;Vallès Oriental;08096;Granollers;4;10;;1839;654;994;1315;524;2;4;1309;1313
8;Barcelona;1;Barcelona;41;Vallès Oriental;08096;Granollers;4;11;;1331;570;765;960;371;0;3;957;960
8;Barcelona;1;Barcelona;41;Vallès Oriental;08096;Granollers;4;2;;1590;544;760;942;648;3;3;936;939
8;Barcelona;1;Barcelona;41;Vallès Oriental;08096;Granollers;4;3;;681;203;292;379;302;0;0;379;379
8;Barcelona;1;Barcelona;41;Vallès Oriental;08096;Granollers;4;4;;1209;405;572;669;540;3;4;662;666
8;Barcelona;1;Barcelona;41;Vallès Oriental;08096;Granollers;4;6;;784;255;353;449;335;1;1;447;448
8;Barcelona;1;Barcelona;41;Vallès Oriental;08096;Granollers;4;7;;1878;645;1004;1266;612;5;11;1250;1261
8;Barcelona;1;Barcelona;41;Vallès Oriental;08096;Granollers;4;8;;980;319;479;604;376;1;0;603;603
8;Barcelona;1;Barcelona;41;Vallès Oriental;08096;Granollers;4;9;;1260;458;653;771;489;2;7;762;769
25;Lleida;4;Lleida;32;Segarra;25103;Granyanella;1;1;;140;51;76;99;41;6;16;77;93
25;Lleida;4;Lleida;18;Garrigues;25105;Granyena de les Garrigues;1;1;;103;51;70;86;17;2;8;76;84
25;Lleida;4;Lleida;32;Segarra;25104;Granyena de Segarra;1;1;;121;47;67;84;37;2;4;78;82
43;Tarragona;6;Camp de Tarragona;29;Priorat;43069;Gratallops;1;1;;179;69;94;129;50;6;14;109;123
8;Barcelona;1;Barcelona;41;Vallès Oriental;08097;Gualba;1;1;;1102;476;638;807;295;12;45;750;795
17;Girona;3;Girona;10;Baix Empordà;17081;Gualta;1;1;;267;110;168;216;51;5;9;202;211
8;Barcelona;2;Catalunya Central;14;Berguedà;08099;Guardiola de Berguedà;1;1;;760;270;430;536;224;9;5;522;527
43;Tarragona;6;Camp de Tarragona;29;Priorat;43070;Guiamets, els;1;1;;238;122;170;205;33;12;11;182;193
17;Girona;5;Alt Pirineu i territori d'Aran;15;Cerdanya;17082;Guils de Cerdanya;1;1;;451;167;253;343;108;2;15;326;341
25;Lleida;4;Lleida;38;Urgell;25109;Guimerà;1;1;;213;95;150;173;40;6;7;160;167
25;Lleida;5;Alt Pirineu i territori d'Aran;26;Pallars Sobirà;25903;Guingueta d'Àneu, la;1;1;;235;89;144;204;31;1;7;196;203
25;Lleida;4;Lleida;32;Segarra;25110;Guissona;1;1;;735;267;414;495;240;13;10;472;482
25;Lleida;4;Lleida;32;Segarra;25110;Guissona;1;2;;1222;442;633;847;375;19;18;810;828
25;Lleida;4;Lleida;32;Segarra;25110;Guissona;1;3;;960;337;480;648;312;13;14;621;635
25;Lleida;2;Catalunya Central;35;Solsonès;25111;Guixers;1;1;;114;61;80;100;14;3;0;97;97
8;Barcelona;2;Catalunya Central;24;Osona;08100;Gurb;1;1;;718;311;448;568;150;4;6;558;564
8;Barcelona;2;Catalunya Central;24;Osona;08100;Gurb;1;2;;1378;503;828;1103;275;2;37;1064;1101
43;Tarragona;7;Terres de l'Ebre;37;Terra Alta;43071;Horta de Sant Joan;1;1;;938;399;589;761;177;13;8;740;748
8;Barcelona;1;Barcelona;13;Barcelonès;08101;Hospitalet de Llobregat, l';1;1;;1249;437;597;800;449;4;4;792;796
8;Barcelona;1;Barcelona;13;Barcelonès;08101;Hospitalet de Llobregat, l';1;10;;883;288;467;587;296;2;2;583;585
8;Barcelona;1;Barcelona;13;Barcelonès;08101;Hospitalet de Llobregat, l';1;11;;655;242;326;425;230;0;3;422;425
8;Barcelona;1;Barcelona;13;Barcelonès;08101;Hospitalet de Llobregat, l';1;12;;1238;460;661;863;375;0;2;861;863
8;Barcelona;1;Barcelona;13;Barcelonès;08101;Hospitalet de Llobregat, l';1;13;;1230;433;620;819;411;2;1;816;817
8;Barcelona;1;Barcelona;13;Barcelonès;08101;Hospitalet de Llobregat, l';1;14;;1112;447;494;684;428;9;6;669;675
8;Barcelona;1;Barcelona;13;Barcelonès;08101;Hospitalet de Llobregat, l';1;15;;930;329;445;579;351;4;5;570;575
8;Barcelona;1;Barcelona;13;Barcelonès;08101;Hospitalet de Llobregat, l';1;16;;1123;441;586;703;420;4;2;697;699
8;Barcelona;1;Barcelona;13;Barcelonès;08101;Hospitalet de Llobregat, l';1;17;;1445;553;743;900;545;4;9;887;896
8;Barcelona;1;Barcelona;13;Barcelonès;08101;Hospitalet de Llobregat, l';1;18;;1235;461;622;784;451;3;4;777;781
8;Barcelona;1;Barcelona;13;Barcelonès;08101;Hospitalet de Llobregat, l';1;19;;1010;385;524;673;337;2;1;670;671
8;Barcelona;1;Barcelona;13;Barcelonès;08101;Hospitalet de Llobregat, l';1;2;;1193;488;611;777;416;3;2;772;774
8;Barcelona;1;Barcelona;13;Barcelonès;08101;Hospitalet de Llobregat, l';1;20;;1307;506;684;871;436;2;6;863;869
8;Barcelona;1;Barcelona;13;Barcelonès;08101;Hospitalet de Llobregat, l';1;21;;617;206;286;334;283;1;2;331;333
8;Barcelona;1;Barcelona;13;Barcelonès;08101;Hospitalet de Llobregat, l';1;22;;663;242;329;422;241;5;0;417;417
8;Barcelona;1;Barcelona;13;Barcelonès;08101;Hospitalet de Llobregat, l';1;23;;959;325;488;630;329;2;4;624;628
8;Barcelona;1;Barcelona;13;Barcelonès;08101;Hospitalet de Llobregat, l';1;24;;647;253;372;479;168;1;1;477;478
8;Barcelona;1;Barcelona;13;Barcelonès;08101;Hospitalet de Llobregat, l';1;25;;1140;373;523;645;495;2;1;642;643
8;Barcelona;1;Barcelona;13;Barcelonès;08101;Hospitalet de Llobregat, l';1;26;;732;285;365;441;291;2;1;438;439
8;Barcelona;1;Barcelona;13;Barcelonès;08101;Hospitalet de Llobregat, l';1;27;;563;192;247;317;246;2;0;315;315
8;Barcelona;1;Barcelona;13;Barcelonès;08101;Hospitalet de Llobregat, l';1;28;;760;258;351;458;302;0;2;456;458
8;Barcelona;1;Barcelona;13;Barcelonès;08101;Hospitalet de Llobregat, l';1;29;;775;240;335;419;356;2;0;417;417
8;Barcelona;1;Barcelona;13;Barcelonès;08101;Hospitalet de Llobregat, l';1;3;;569;219;302;381;188;3;3;375;378
8;Barcelona;1;Barcelona;13;Barcelonès;08101;Hospitalet de Llobregat, l';1;30;;782;271;421;501;281;1;1;499;500
8;Barcelona;1;Barcelona;13;Barcelonès;08101;Hospitalet de Llobregat, l';1;31;;977;388;491;594;383;3;0;591;591
8;Barcelona;1;Barcelona;13;Barcelonès;08101;Hospitalet de Llobregat, l';1;32;;1606;515;730;904;702;3;5;896;901
8;Barcelona;1;Barcelona;13;Barcelonès;08101;Hospitalet de Llobregat, l';1;33;;648;263;356;441;207;0;4;437;441
8;Barcelona;1;Barcelona;13;Barcelonès;08101;Hospitalet de Llobregat, l';1;34;;1055;384;633;720;335;1;1;718;719
8;Barcelona;1;Barcelona;13;Barcelonès;08101;Hospitalet de Llobregat, l';1;35;;1145;404;573;744;401;1;3;740;743
8;Barcelona;1;Barcelona;13;Barcelonès;08101;Hospitalet de Llobregat, l';1;36;;889;356;486;592;297;2;3;587;590
8;Barcelona;1;Barcelona;13;Barcelonès;08101;Hospitalet de Llobregat, l';1;37;;1075;435;568;712;363;1;2;709;711
8;Barcelona;1;Barcelona;13;Barcelonès;08101;Hospitalet de Llobregat, l';1;38;;610;230;316;427;183;0;3;424;427
8;Barcelona;1;Barcelona;13;Barcelonès;08101;Hospitalet de Llobregat, l';1;39;;656;204;288;370;286;0;0;370;370
8;Barcelona;1;Barcelona;13;Barcelonès;08101;Hospitalet de Llobregat, l';1;4;;655;263;368;464;191;1;0;463;463
8;Barcelona;1;Barcelona;13;Barcelonès;08101;Hospitalet de Llobregat, l';1;40;;633;220;290;337;296;0;1;336;337
8;Barcelona;1;Barcelona;13;Barcelonès;08101;Hospitalet de Llobregat, l';1;41;;792;300;433;616;176;6;4;606;610
8;Barcelona;1;Barcelona;13;Barcelonès;08101;Hospitalet de Llobregat, l';1;5;;914;314;461;607;307;3;4;600;604
8;Barcelona;1;Barcelona;13;Barcelonès;08101;Hospitalet de Llobregat, l';1;6;;1338;479;649;820;518;0;6;814;820
8;Barcelona;1;Barcelona;13;Barcelonès;08101;Hospitalet de Llobregat, l';1;7;;1129;362;535;674;455;1;3;670;673
8;Barcelona;1;Barcelona;13;Barcelonès;08101;Hospitalet de Llobregat, l';1;8;;1068;400;553;726;342;2;7;717;724
8;Barcelona;1;Barcelona;13;Barcelonès;08101;Hospitalet de Llobregat, l';1;9;;900;374;514;647;253;0;1;646;647
8;Barcelona;1;Barcelona;13;Barcelonès;08101;Hospitalet de Llobregat, l';2;1;;1041;319;442;604;437;1;3;600;603
8;Barcelona;1;Barcelona;13;Barcelonès;08101;Hospitalet de Llobregat, l';2;10;;617;207;283;372;245;0;3;369;372
8;Barcelona;1;Barcelona;13;Barcelonès;08101;Hospitalet de Llobregat, l';2;11;;750;190;259;321;429;1;0;320;320
8;Barcelona;1;Barcelona;13;Barcelonès;08101;Hospitalet de Llobregat, l';2;12;;790;254;317;397;393;3;1;393;394
8;Barcelona;1;Barcelona;13;Barcelonès;08101;Hospitalet de Llobregat, l';2;13;;567;167;231;293;274;2;2;289;291
8;Barcelona;1;Barcelona;13;Barcelonès;08101;Hospitalet de Llobregat, l';2;14;;1226;371;490;611;615;2;0;609;609
8;Barcelona;1;Barcelona;13;Barcelonès;08101;Hospitalet de Llobregat, l';2;16;;838;279;372;444;394;3;3;438;441
8;Barcelona;1;Barcelona;13;Barcelonès;08101;Hospitalet de Llobregat, l';2;17;;856;265;385;453;403;3;2;448;450
8;Barcelona;1;Barcelona;13;Barcelonès;08101;Hospitalet de Llobregat, l';2;2;;970;263;361;457;513;4;5;448;453
8;Barcelona;1;Barcelona;13;Barcelonès;08101;Hospitalet de Llobregat, l';2;20;;965;276;372;481;484;4;2;475;477
8;Barcelona;1;Barcelona;13;Barcelonès;08101;Hospitalet de Llobregat, l';2;21;;1167;329;465;565;602;5;1;559;560
8;Barcelona;1;Barcelona;13;Barcelonès;08101;Hospitalet de Llobregat, l';2;23;;689;243;305;377;312;3;0;374;374
8;Barcelona;1;Barcelona;13;Barcelonès;08101;Hospitalet de Llobregat, l';2;24;;695;232;286;353;342;3;3;347;350
8;Barcelona;1;Barcelona;13;Barcelonès;08101;Hospitalet de Llobregat, l';2;26;;1133;343;499;613;520;1;2;610;612
8;Barcelona;1;Barcelona;13;Barcelonès;08101;Hospitalet de Llobregat, l';2;28;;1270;323;506;583;687;0;6;577;583
8;Barcelona;1;Barcelona;13;Barcelonès;08101;Hospitalet de Llobregat, l';2;29;;943;217;288;378;565;6;2;370;372
8;Barcelona;1;Barcelona;13;Barcelonès;08101;Hospitalet de Llobregat, l';2;31;;662;201;270;333;329;2;0;331;331
8;Barcelona;1;Barcelona;13;Barcelonès;08101;Hospitalet de Llobregat, l';2;32;;640;228;298;351;289;0;1;350;351
8;Barcelona;1;Barcelona;13;Barcelonès;08101;Hospitalet de Llobregat, l';2;33;;560;170;227;279;281;2;0;277;277
8;Barcelona;1;Barcelona;13;Barcelonès;08101;Hospitalet de Llobregat, l';2;34;;585;173;231;290;295;4;4;282;286
8;Barcelona;1;Barcelona;13;Barcelonès;08101;Hospitalet de Llobregat, l';2;36;;645;210;302;358;287;2;2;354;356
8;Barcelona;1;Barcelona;13;Barcelonès;08101;Hospitalet de Llobregat, l';2;37;;793;215;305;364;429;0;2;362;364
8;Barcelona;1;Barcelona;13;Barcelonès;08101;Hospitalet de Llobregat, l';2;38;;561;170;242;298;263;0;3;295;298
8;Barcelona;1;Barcelona;13;Barcelonès;08101;Hospitalet de Llobregat, l';2;39;;690;252;332;397;293;3;2;392;394
8;Barcelona;1;Barcelona;13;Barcelonès;08101;Hospitalet de Llobregat, l';2;4;;915;291;384;468;447;5;4;459;463
8;Barcelona;1;Barcelona;13;Barcelonès;08101;Hospitalet de Llobregat, l';2;40;;969;301;426;519;450;3;3;513;516
8;Barcelona;1;Barcelona;13;Barcelonès;08101;Hospitalet de Llobregat, l';2;42;;730;222;308;379;351;2;2;375;377
8;Barcelona;1;Barcelona;13;Barcelonès;08101;Hospitalet de Llobregat, l';2;43;;1038;310;405;543;495;3;4;536;540
8;Barcelona;1;Barcelona;13;Barcelonès;08101;Hospitalet de Llobregat, l';2;45;;637;194;264;336;301;0;1;335;336
8;Barcelona;1;Barcelona;13;Barcelonès;08101;Hospitalet de Llobregat, l';2;46;;686;218;281;349;337;2;1;346;347
8;Barcelona;1;Barcelona;13;Barcelonès;08101;Hospitalet de Llobregat, l';2;47;;690;198;280;367;323;1;1;365;366
8;Barcelona;1;Barcelona;13;Barcelonès;08101;Hospitalet de Llobregat, l';2;48;;740;222;326;388;352;1;0;387;387
8;Barcelona;1;Barcelona;13;Barcelonès;08101;Hospitalet de Llobregat, l';2;49;;636;209;278;332;304;3;6;323;329
8;Barcelona;1;Barcelona;13;Barcelonès;08101;Hospitalet de Llobregat, l';2;5;;649;214;281;364;285;4;4;356;360
8;Barcelona;1;Barcelona;13;Barcelonès;08101;Hospitalet de Llobregat, l';2;7;;1082;373;502;613;469;3;0;610;610
8;Barcelona;1;Barcelona;13;Barcelonès;08101;Hospitalet de Llobregat, l';2;8;;1242;428;567;716;526;1;7;708;715
8;Barcelona;1;Barcelona;13;Barcelonès;08101;Hospitalet de Llobregat, l';2;9;;633;229;304;374;259;4;1;369;370
8;Barcelona;1;Barcelona;13;Barcelonès;08101;Hospitalet de Llobregat, l';3;1;;1043;366;482;587;456;3;4;580;584
8;Barcelona;1;Barcelona;13;Barcelonès;08101;Hospitalet de Llobregat, l';3;10;;636;223;304;366;270;1;2;363;365
8;Barcelona;1;Barcelona;13;Barcelonès;08101;Hospitalet de Llobregat, l';3;11;;949;283;397;489;460;8;0;481;481
8;Barcelona;1;Barcelona;13;Barcelonès;08101;Hospitalet de Llobregat, l';3;12;;1195;391;575;712;483;4;2;706;708
8;Barcelona;1;Barcelona;13;Barcelonès;08101;Hospitalet de Llobregat, l';3;13;;1375;489;696;841;534;1;1;839;840
8;Barcelona;1;Barcelona;13;Barcelonès;08101;Hospitalet de Llobregat, l';3;14;;1682;544;771;971;711;5;8;958;966
8;Barcelona;1;Barcelona;13;Barcelonès;08101;Hospitalet de Llobregat, l';3;15;;1254;448;594;738;516;2;3;733;736
8;Barcelona;1;Barcelona;13;Barcelonès;08101;Hospitalet de Llobregat, l';3;16;;1691;680;965;1219;472;7;2;1210;1212
8;Barcelona;1;Barcelona;13;Barcelonès;08101;Hospitalet de Llobregat, l';3;17;;606;161;221;297;309;3;0;294;294
8;Barcelona;1;Barcelona;13;Barcelonès;08101;Hospitalet de Llobregat, l';3;18;;632;202;304;403;229;1;2;400;402
8;Barcelona;1;Barcelona;13;Barcelonès;08101;Hospitalet de Llobregat, l';3;19;;1138;407;598;783;355;0;4;779;783
8;Barcelona;1;Barcelona;13;Barcelonès;08101;Hospitalet de Llobregat, l';3;2;;1002;305;450;577;425;1;1;575;576
8;Barcelona;1;Barcelona;13;Barcelonès;08101;Hospitalet de Llobregat, l';3;20;;1131;386;543;682;449;1;1;680;681
8;Barcelona;1;Barcelona;13;Barcelonès;08101;Hospitalet de Llobregat, l';3;21;;1767;629;919;1197;570;5;4;1188;1192
8;Barcelona;1;Barcelona;13;Barcelonès;08101;Hospitalet de Llobregat, l';3;22;;866;277;392;490;376;5;1;484;485
8;Barcelona;1;Barcelona;13;Barcelonès;08101;Hospitalet de Llobregat, l';3;23;;1345;474;649;817;528;7;3;807;810
8;Barcelona;1;Barcelona;13;Barcelonès;08101;Hospitalet de Llobregat, l';3;24;;679;217;310;383;296;1;1;381;382
8;Barcelona;1;Barcelona;13;Barcelonès;08101;Hospitalet de Llobregat, l';3;25;;1366;517;723;890;476;1;2;887;889
8;Barcelona;1;Barcelona;13;Barcelonès;08101;Hospitalet de Llobregat, l';3;26;;798;265;397;542;256;2;2;538;540
8;Barcelona;1;Barcelona;13;Barcelonès;08101;Hospitalet de Llobregat, l';3;27;;951;306;456;599;352;1;7;591;598
8;Barcelona;1;Barcelona;13;Barcelonès;08101;Hospitalet de Llobregat, l';3;28;;939;331;458;643;296;0;2;641;643
8;Barcelona;1;Barcelona;13;Barcelonès;08101;Hospitalet de Llobregat, l';3;29;;1018;365;520;677;341;2;6;669;675
8;Barcelona;1;Barcelona;13;Barcelonès;08101;Hospitalet de Llobregat, l';3;3;;1117;401;572;670;447;3;2;665;667
8;Barcelona;1;Barcelona;13;Barcelonès;08101;Hospitalet de Llobregat, l';3;4;;1290;414;564;757;533;5;5;747;752
8;Barcelona;1;Barcelona;13;Barcelonès;08101;Hospitalet de Llobregat, l';3;5;;1138;399;561;712;426;0;5;707;712
8;Barcelona;1;Barcelona;13;Barcelonès;08101;Hospitalet de Llobregat, l';3;6;;1102;391;525;644;458;1;0;643;643
8;Barcelona;1;Barcelona;13;Barcelonès;08101;Hospitalet de Llobregat, l';3;7;;1062;447;593;735;327;0;1;734;735
8;Barcelona;1;Barcelona;13;Barcelonès;08101;Hospitalet de Llobregat, l';3;8;;1485;577;825;1046;439;5;8;1033;1041
8;Barcelona;1;Barcelona;13;Barcelonès;08101;Hospitalet de Llobregat, l';3;9;;795;259;393;485;310;1;1;483;484
8;Barcelona;1;Barcelona;13;Barcelonès;08101;Hospitalet de Llobregat, l';4;1;;796;258;348;442;354;2;5;435;440
8;Barcelona;1;Barcelona;13;Barcelonès;08101;Hospitalet de Llobregat, l';4;10;;1135;408;546;650;485;0;2;648;650
8;Barcelona;1;Barcelona;13;Barcelonès;08101;Hospitalet de Llobregat, l';4;11;;658;228;306;376;282;0;1;375;376
8;Barcelona;1;Barcelona;13;Barcelonès;08101;Hospitalet de Llobregat, l';4;12;;1033;364;488;603;430;0;1;602;603
8;Barcelona;1;Barcelona;13;Barcelonès;08101;Hospitalet de Llobregat, l';4;14;;970;264;381;466;504;2;4;460;464
8;Barcelona;1;Barcelona;13;Barcelonès;08101;Hospitalet de Llobregat, l';4;16;;812;257;338;407;405;3;0;404;404
8;Barcelona;1;Barcelona;13;Barcelonès;08101;Hospitalet de Llobregat, l';4;18;;804;250;316;390;414;3;0;387;387
8;Barcelona;1;Barcelona;13;Barcelonès;08101;Hospitalet de Llobregat, l';4;19;;1059;296;420;490;569;2;4;484;488
8;Barcelona;1;Barcelona;13;Barcelonès;08101;Hospitalet de Llobregat, l';4;2;;534;166;215;252;282;1;6;245;251
8;Barcelona;1;Barcelona;13;Barcelonès;08101;Hospitalet de Llobregat, l';4;20;;1202;357;525;634;568;0;4;630;634
8;Barcelona;1;Barcelona;13;Barcelonès;08101;Hospitalet de Llobregat, l';4;21;;777;263;351;426;351;2;1;423;424
8;Barcelona;1;Barcelona;13;Barcelonès;08101;Hospitalet de Llobregat, l';4;22;;678;183;249;297;381;1;1;295;296
8;Barcelona;1;Barcelona;13;Barcelonès;08101;Hospitalet de Llobregat, l';4;23;;586;232;290;322;264;0;0;322;322
8;Barcelona;1;Barcelona;13;Barcelonès;08101;Hospitalet de Llobregat, l';4;25;;600;200;260;314;286;3;1;310;311
8;Barcelona;1;Barcelona;13;Barcelonès;08101;Hospitalet de Llobregat, l';4;26;;564;161;216;264;300;1;1;262;263
8;Barcelona;1;Barcelona;13;Barcelonès;08101;Hospitalet de Llobregat, l';4;27;;789;204;271;324;465;2;2;320;322
8;Barcelona;1;Barcelona;13;Barcelonès;08101;Hospitalet de Llobregat, l';4;3;;774;272;378;455;319;0;1;454;455
8;Barcelona;1;Barcelona;13;Barcelonès;08101;Hospitalet de Llobregat, l';4;30;;581;150;194;242;339;1;2;239;241
8;Barcelona;1;Barcelona;13;Barcelonès;08101;Hospitalet de Llobregat, l';4;31;;752;228;354;356;396;0;0;356;356
8;Barcelona;1;Barcelona;13;Barcelonès;08101;Hospitalet de Llobregat, l';4;32;;771;248;338;410;361;2;1;407;408
8;Barcelona;1;Barcelona;13;Barcelonès;08101;Hospitalet de Llobregat, l';4;33;;981;232;320;383;598;4;1;378;379
8;Barcelona;1;Barcelona;13;Barcelonès;08101;Hospitalet de Llobregat, l';4;35;;556;128;166;190;366;5;0;185;185
8;Barcelona;1;Barcelona;13;Barcelonès;08101;Hospitalet de Llobregat, l';4;36;;881;264;337;414;467;0;1;413;414
8;Barcelona;1;Barcelona;13;Barcelonès;08101;Hospitalet de Llobregat, l';4;37;;974;280;385;472;502;1;0;471;471
8;Barcelona;1;Barcelona;13;Barcelonès;08101;Hospitalet de Llobregat, l';4;4;;824;286;363;420;404;2;3;415;418
8;Barcelona;1;Barcelona;13;Barcelonès;08101;Hospitalet de Llobregat, l';4;40;;682;264;331;393;289;0;4;389;393
8;Barcelona;1;Barcelona;13;Barcelonès;08101;Hospitalet de Llobregat, l';4;41;;1430;500;710;831;599;0;4;827;831
8;Barcelona;1;Barcelona;13;Barcelonès;08101;Hospitalet de Llobregat, l';4;5;;1086;286;390;497;589;3;1;493;494
8;Barcelona;1;Barcelona;13;Barcelonès;08101;Hospitalet de Llobregat, l';4;6;;895;274;372;440;455;1;1;438;439
8;Barcelona;1;Barcelona;13;Barcelonès;08101;Hospitalet de Llobregat, l';4;7;;576;157;216;271;305;0;1;270;271
8;Barcelona;1;Barcelona;13;Barcelonès;08101;Hospitalet de Llobregat, l';4;9;;1117;344;451;573;544;2;2;569;571
8;Barcelona;1;Barcelona;13;Barcelonès;08101;Hospitalet de Llobregat, l';5;1;;847;310;409;507;340;2;0;505;505
8;Barcelona;1;Barcelona;13;Barcelonès;08101;Hospitalet de Llobregat, l';5;10;;680;230;301;370;310;5;4;361;365
8;Barcelona;1;Barcelona;13;Barcelonès;08101;Hospitalet de Llobregat, l';5;11;;1282;333;486;618;664;1;4;613;617
8;Barcelona;1;Barcelona;13;Barcelonès;08101;Hospitalet de Llobregat, l';5;13;;825;234;317;403;422;2;3;398;401
8;Barcelona;1;Barcelona;13;Barcelonès;08101;Hospitalet de Llobregat, l';5;14;;821;223;288;344;477;1;1;342;343
8;Barcelona;1;Barcelona;13;Barcelonès;08101;Hospitalet de Llobregat, l';5;17;;1126;302;397;483;643;4;6;473;479
8;Barcelona;1;Barcelona;13;Barcelonès;08101;Hospitalet de Llobregat, l';5;18;;719;242;315;385;334;0;6;379;385
8;Barcelona;1;Barcelona;13;Barcelonès;08101;Hospitalet de Llobregat, l';5;2;;1072;348;457;564;508;0;4;560;564
8;Barcelona;1;Barcelona;13;Barcelonès;08101;Hospitalet de Llobregat, l';5;20;;562;190;244;305;257;1;3;301;304
8;Barcelona;1;Barcelona;13;Barcelonès;08101;Hospitalet de Llobregat, l';5;21;;751;312;403;509;242;2;2;505;507
8;Barcelona;1;Barcelona;13;Barcelonès;08101;Hospitalet de Llobregat, l';5;23;;855;243;363;447;408;3;3;441;444
8;Barcelona;1;Barcelona;13;Barcelonès;08101;Hospitalet de Llobregat, l';5;24;;686;209;280;331;355;2;0;329;329
8;Barcelona;1;Barcelona;13;Barcelonès;08101;Hospitalet de Llobregat, l';5;25;;537;160;209;271;266;0;2;269;271
8;Barcelona;1;Barcelona;13;Barcelonès;08101;Hospitalet de Llobregat, l';5;26;;1011;264;341;419;592;1;1;417;418
8;Barcelona;1;Barcelona;13;Barcelonès;08101;Hospitalet de Llobregat, l';5;28;;718;209;315;379;339;5;1;373;374
8;Barcelona;1;Barcelona;13;Barcelonès;08101;Hospitalet de Llobregat, l';5;29;;771;222;294;373;398;1;0;372;372
8;Barcelona;1;Barcelona;13;Barcelonès;08101;Hospitalet de Llobregat, l';5;3;;637;276;334;430;207;1;1;428;429
8;Barcelona;1;Barcelona;13;Barcelonès;08101;Hospitalet de Llobregat, l';5;30;;1070;323;448;580;490;1;2;577;579
8;Barcelona;1;Barcelona;13;Barcelonès;08101;Hospitalet de Llobregat, l';5;31;;566;166;213;255;311;1;0;254;254
8;Barcelona;1;Barcelona;13;Barcelonès;08101;Hospitalet de Llobregat, l';5;32;;829;255;368;445;384;5;3;437;440
8;Barcelona;1;Barcelona;13;Barcelonès;08101;Hospitalet de Llobregat, l';5;33;;1080;348;467;581;499;2;6;573;579
8;Barcelona;1;Barcelona;13;Barcelonès;08101;Hospitalet de Llobregat, l';5;34;;596;184;258;308;288;2;1;305;306
8;Barcelona;1;Barcelona;13;Barcelonès;08101;Hospitalet de Llobregat, l';5;35;;762;284;371;470;292;3;0;467;467
8;Barcelona;1;Barcelona;13;Barcelonès;08101;Hospitalet de Llobregat, l';5;37;;797;279;387;454;343;2;3;449;452
8;Barcelona;1;Barcelona;13;Barcelonès;08101;Hospitalet de Llobregat, l';5;38;;815;243;338;439;376;2;3;434;437
8;Barcelona;1;Barcelona;13;Barcelonès;08101;Hospitalet de Llobregat, l';5;4;;781;254;368;462;319;0;2;460;462
8;Barcelona;1;Barcelona;13;Barcelonès;08101;Hospitalet de Llobregat, l';5;5;;941;324;466;590;351;2;3;585;588
8;Barcelona;1;Barcelona;13;Barcelonès;08101;Hospitalet de Llobregat, l';5;6;;1350;469;661;833;517;2;2;829;831
8;Barcelona;1;Barcelona;13;Barcelonès;08101;Hospitalet de Llobregat, l';5;7;;578;195;272;334;244;1;1;332;333
8;Barcelona;1;Barcelona;13;Barcelonès;08101;Hospitalet de Llobregat, l';5;8;;869;257;354;434;435;1;0;433;433
8;Barcelona;1;Barcelona;13;Barcelonès;08101;Hospitalet de Llobregat, l';6;1;;1460;478;653;860;600;5;3;852;855
8;Barcelona;1;Barcelona;13;Barcelonès;08101;Hospitalet de Llobregat, l';6;10;;887;330;448;541;346;3;0;538;538
8;Barcelona;1;Barcelona;13;Barcelonès;08101;Hospitalet de Llobregat, l';6;11;;1239;359;521;679;560;1;3;675;678
8;Barcelona;1;Barcelona;13;Barcelonès;08101;Hospitalet de Llobregat, l';6;12;;753;232;351;422;331;1;0;421;421
8;Barcelona;1;Barcelona;13;Barcelonès;08101;Hospitalet de Llobregat, l';6;13;;888;321;436;570;318;1;0;569;569
8;Barcelona;1;Barcelona;13;Barcelonès;08101;Hospitalet de Llobregat, l';6;14;;731;278;371;450;281;2;2;446;448
8;Barcelona;1;Barcelona;13;Barcelonès;08101;Hospitalet de Llobregat, l';6;15;;599;230;321;411;188;0;2;409;411
8;Barcelona;1;Barcelona;13;Barcelonès;08101;Hospitalet de Llobregat, l';6;16;;1611;405;612;774;837;2;4;768;772
8;Barcelona;1;Barcelona;13;Barcelonès;08101;Hospitalet de Llobregat, l';6;17;;731;234;317;405;326;1;2;402;404
8;Barcelona;1;Barcelona;13;Barcelonès;08101;Hospitalet de Llobregat, l';6;18;;905;374;516;682;223;2;2;678;680
8;Barcelona;1;Barcelona;13;Barcelonès;08101;Hospitalet de Llobregat, l';6;19;;993;370;493;644;349;5;1;638;639
8;Barcelona;1;Barcelona;13;Barcelonès;08101;Hospitalet de Llobregat, l';6;2;;873;282;409;487;386;2;3;482;485
8;Barcelona;1;Barcelona;13;Barcelonès;08101;Hospitalet de Llobregat, l';6;21;;1069;396;530;652;417;2;2;648;650
8;Barcelona;1;Barcelona;13;Barcelonès;08101;Hospitalet de Llobregat, l';6;22;;637;213;288;354;283;1;2;351;353
8;Barcelona;1;Barcelona;13;Barcelonès;08101;Hospitalet de Llobregat, l';6;23;;1052;403;572;708;344;0;3;705;708
8;Barcelona;1;Barcelona;13;Barcelonès;08101;Hospitalet de Llobregat, l';6;24;;800;262;347;442;358;2;3;437;440
8;Barcelona;1;Barcelona;13;Barcelonès;08101;Hospitalet de Llobregat, l';6;25;;927;385;502;639;288;3;3;633;636
8;Barcelona;1;Barcelona;13;Barcelonès;08101;Hospitalet de Llobregat, l';6;26;;713;251;341;432;281;2;3;427;430
8;Barcelona;1;Barcelona;13;Barcelonès;08101;Hospitalet de Llobregat, l';6;27;;735;296;386;486;249;1;1;484;485
8;Barcelona;1;Barcelona;13;Barcelonès;08101;Hospitalet de Llobregat, l';6;30;;625;239;297;387;238;3;0;384;384
8;Barcelona;1;Barcelona;13;Barcelonès;08101;Hospitalet de Llobregat, l';6;31;;786;266;421;489;297;3;3;483;486
8;Barcelona;1;Barcelona;13;Barcelonès;08101;Hospitalet de Llobregat, l';6;32;;698;206;285;356;342;0;0;356;356
8;Barcelona;1;Barcelona;13;Barcelonès;08101;Hospitalet de Llobregat, l';6;5;;1205;459;617;779;426;2;4;773;777
8;Barcelona;1;Barcelona;13;Barcelonès;08101;Hospitalet de Llobregat, l';6;6;;678;208;299;354;324;1;0;353;353
8;Barcelona;1;Barcelona;13;Barcelonès;08101;Hospitalet de Llobregat, l';6;7;;737;219;313;398;339;2;4;392;396
8;Barcelona;1;Barcelona;13;Barcelonès;08101;Hospitalet de Llobregat, l';6;8;;1035;297;450;541;494;2;1;538;539
8;Barcelona;1;Barcelona;13;Barcelonès;08101;Hospitalet de Llobregat, l';6;9;;617;230;292;374;243;0;1;373;374
8;Barcelona;8;Penedès;6;Anoia;08162;Hostalets de Pierola, els;1;1;;2126;889;1247;1519;607;11;23;1485;1508
17;Girona;3;Girona;34;Selva;17083;Hostalric;1;1;;757;350;474;540;217;4;9;527;536
17;Girona;3;Girona;34;Selva;17083;Hostalric;1;2;;1413;626;858;1025;388;7;11;1007;1018
17;Girona;3;Girona;34;Selva;17083;Hostalric;1;3;;813;321;441;577;236;3;5;569;574
8;Barcelona;8;Penedès;6;Anoia;08102;Igualada;1;1;;1241;441;572;703;538;2;7;694;701
8;Barcelona;8;Penedès;6;Anoia;08102;Igualada;2;1;;634;263;350;436;198;3;3;430;433
8;Barcelona;8;Penedès;6;Anoia;08102;Igualada;2;2;;885;344;472;583;302;3;1;579;580
8;Barcelona;8;Penedès;6;Anoia;08102;Igualada;2;3;;1255;484;680;862;393;2;2;858;860
8;Barcelona;8;Penedès;6;Anoia;08102;Igualada;3;1;;875;307;434;529;346;3;4;522;526
8;Barcelona;8;Penedès;6;Anoia;08102;Igualada;3;10;;1166;418;602;808;358;2;5;801;806
8;Barcelona;8;Penedès;6;Anoia;08102;Igualada;3;2;;1461;510;734;993;468;3;9;981;990
8;Barcelona;8;Penedès;6;Anoia;08102;Igualada;3;3;;971;402;552;671;300;1;4;666;670
8;Barcelona;8;Penedès;6;Anoia;08102;Igualada;3;4;;1614;587;823;1041;573;8;7;1026;1033
8;Barcelona;8;Penedès;6;Anoia;08102;Igualada;3;5;;771;308;418;508;263;2;1;505;506
8;Barcelona;8;Penedès;6;Anoia;08102;Igualada;3;6;;1435;546;795;1040;395;3;10;1027;1037
8;Barcelona;8;Penedès;6;Anoia;08102;Igualada;3;7;;1749;593;926;1249;500;6;5;1238;1243
8;Barcelona;8;Penedès;6;Anoia;08102;Igualada;3;8;;1094;353;536;732;362;5;2;725;727
8;Barcelona;8;Penedès;6;Anoia;08102;Igualada;3;9;;1347;541;747;977;370;0;5;972;977
8;Barcelona;8;Penedès;6;Anoia;08102;Igualada;4;1;;713;295;388;458;255;2;6;450;456
8;Barcelona;8;Penedès;6;Anoia;08102;Igualada;4;2;;763;311;407;517;246;1;7;509;516
8;Barcelona;8;Penedès;6;Anoia;08102;Igualada;4;3;;830;355;448;549;281;4;2;543;545
8;Barcelona;8;Penedès;6;Anoia;08102;Igualada;4;4;;901;365;483;631;270;1;1;629;630
8;Barcelona;8;Penedès;6;Anoia;08102;Igualada;4;5;;1279;488;664;871;408;9;9;853;862
8;Barcelona;8;Penedès;6;Anoia;08102;Igualada;5;1;;1101;428;561;707;394;2;7;698;705
8;Barcelona;8;Penedès;6;Anoia;08102;Igualada;5;2;;1234;440;607;785;449;0;4;781;785
8;Barcelona;8;Penedès;6;Anoia;08102;Igualada;5;3;;1483;591;774;1002;481;2;6;994;1000
8;Barcelona;8;Penedès;6;Anoia;08102;Igualada;5;4;;1126;490;654;806;320;4;6;796;802
8;Barcelona;8;Penedès;6;Anoia;08102;Igualada;5;5;;521;148;231;264;257;3;1;260;261
8;Barcelona;8;Penedès;6;Anoia;08102;Igualada;5;6;;607;189;246;296;311;0;1;295;296
8;Barcelona;8;Penedès;6;Anoia;08102;Igualada;5;7;;1883;672;1018;1284;599;4;9;1271;1280
25;Lleida;5;Alt Pirineu i territori d'Aran;25;Pallars Jussà;25115;Isona i Conca Dellà;1;1;;811;355;503;646;165;5;25;616;641
17;Girona;5;Alt Pirineu i territori d'Aran;15;Cerdanya;17084;Isòvol;1;1;;231;96;140;177;54;1;9;167;176
25;Lleida;4;Lleida;27;Pla d'Urgell;25113;Ivars d'Urgell;1;1;;499;243;330;398;101;6;11;381;392
25;Lleida;4;Lleida;27;Pla d'Urgell;25113;Ivars d'Urgell;1;2;;624;316;423;505;119;11;14;480;494
25;Lleida;4;Lleida;23;Noguera;25112;Ivars de Noguera;1;1;;267;109;167;211;56;5;52;154;206
25;Lleida;4;Lleida;32;Segarra;25114;Ivorra;1;1;;95;50;68;85;10;0;0;85;85
17;Girona;3;Girona;10;Baix Empordà;17085;Jafre;1;1;;297;141;222;256;41;6;17;233;250
17;Girona;3;Girona;2;Alt Empordà;17086;Jonquera, la;1;1;;1148;459;639;774;374;6;10;758;768
17;Girona;3;Girona;2;Alt Empordà;17086;Jonquera, la;1;2;;620;282;381;442;178;2;6;434;440
8;Barcelona;8;Penedès;6;Anoia;08103;Jorba;1;1;;650;240;348;467;183;14;26;427;453
25;Lleida;5;Alt Pirineu i territori d'Aran;4;Alt Urgell;25910;Josa i Tuixén;1;1;;93;38;57;65;28;0;1;64;65
17;Girona;3;Girona;20;Gironès;17087;Juià;1;1;;225;87;111;194;31;8;13;173;186
25;Lleida;4;Lleida;18;Garrigues;25118;Juncosa;1;1;;336;148;180;225;111;13;37;175;212
25;Lleida;4;Lleida;18;Garrigues;25119;Juneda;1;1;;1278;501;744;937;341;4;11;922;933
25;Lleida;4;Lleida;18;Garrigues;25119;Juneda;1;2;;1032;454;644;828;204;15;13;800;813
25;Lleida;5;Alt Pirineu i territori d'Aran;39;Consell General d'Aran;25121;Les;1;1;;676;236;351;508;168;7;6;495;501
25;Lleida;4;Lleida;27;Pla d'Urgell;25122;Linyola;1;1;;877;378;532;654;223;7;58;589;647
25;Lleida;4;Lleida;27;Pla d'Urgell;25122;Linyola;1;2;;1066;428;612;794;272;23;32;739;771
8;Barcelona;8;Penedès;6;Anoia;08104;Llacuna, la;1;1;;665;331;430;528;137;20;25;483;508
17;Girona;3;Girona;2;Alt Empordà;17088;Lladó;1;1;;588;211;297;376;212;16;73;287;360
25;Lleida;5;Alt Pirineu i territori d'Aran;26;Pallars Sobirà;25123;Lladorre;1;1;;194;49;93;168;26;2;4;162;166
25;Lleida;2;Catalunya Central;35;Solsonès;25124;Lladurs;1;1;;158;66;102;132;26;3;0;129;129
8;Barcelona;1;Barcelona;41;Vallès Oriental;08105;Llagosta, la;1;1;;1186;404;564;680;506;4;2;674;676
8;Barcelona;1;Barcelona;41;Vallès Oriental;08105;Llagosta, la;1;2;;1257;434;602;770;487;3;6;761;767
8;Barcelona;1;Barcelona;41;Vallès Oriental;08105;Llagosta, la;1;3;;1046;405;533;674;372;4;10;660;670
8;Barcelona;1;Barcelona;41;Vallès Oriental;08105;Llagosta, la;1;4;;1099;375;512;659;440;7;6;646;652
8;Barcelona;1;Barcelona;41;Vallès Oriental;08105;Llagosta, la;1;5;;1153;413;532;679;474;9;7;663;670
8;Barcelona;1;Barcelona;41;Vallès Oriental;08105;Llagosta, la;1;6;;933;369;479;574;359;3;2;569;571
8;Barcelona;1;Barcelona;41;Vallès Oriental;08105;Llagosta, la;1;7;;1013;402;500;606;407;4;0;602;602
8;Barcelona;1;Barcelona;41;Vallès Oriental;08105;Llagosta, la;1;8;;896;355;485;622;274;2;1;619;620
8;Barcelona;1;Barcelona;41;Vallès Oriental;08105;Llagosta, la;1;9;;1166;424;605;783;383;4;7;772;779
17;Girona;3;Girona;20;Gironès;17089;Llagostera;1;1;;1255;411;588;756;499;11;14;731;745
17;Girona;3;Girona;20;Gironès;17089;Llagostera;1;2;;1204;478;651;817;387;5;7;805;812
17;Girona;3;Girona;20;Gironès;17089;Llagostera;1;3;;1918;705;1008;1232;686;13;12;1207;1219
17;Girona;3;Girona;20;Gironès;17089;Llagostera;1;4;;1384;459;701;938;446;6;11;921;932
17;Girona;3;Girona;20;Gironès;17090;Llambilles;1;1;;540;251;365;463;77;2;16;445;461
17;Girona;3;Girona;31;Ripollès;17091;Llanars;1;1;;399;180;240;278;121;10;21;247;268
17;Girona;3;Girona;2;Alt Empordà;17092;Llançà;1;1;;1077;435;606;744;333;5;18;721;739
17;Girona;3;Girona;2;Alt Empordà;17092;Llançà;1;2;;1665;694;1035;1238;427;22;16;1200;1216
17;Girona;3;Girona;2;Alt Empordà;17092;Llançà;1;3;;855;332;477;603;252;12;6;585;591
25;Lleida;4;Lleida;33;Segrià;25125;Llardecans;1;1;;387;155;202;266;121;4;25;237;262
25;Lleida;5;Alt Pirineu i territori d'Aran;26;Pallars Sobirà;25126;Llavorsí;1;1;;286;129;201;262;24;3;3;256;259
25;Lleida;4;Lleida;33;Segrià;25120;Lleida;1;1;;1440;519;689;928;512;2;10;916;926
25;Lleida;4;Lleida;33;Segrià;25120;Lleida;1;10;;1175;331;448;616;559;5;6;605;611
25;Lleida;4;Lleida;33;Segrià;25120;Lleida;1;11;;1070;350;486;615;455;5;9;601;610
25;Lleida;4;Lleida;33;Segrià;25120;Lleida;1;12;;772;229;300;380;392;0;5;375;380
25;Lleida;4;Lleida;33;Segrià;25120;Lleida;1;13;;1381;477;676;878;503;3;7;868;875
25;Lleida;4;Lleida;33;Segrià;25120;Lleida;1;14;;1361;523;717;897;464;7;2;888;890
25;Lleida;4;Lleida;33;Segrià;25120;Lleida;1;3;;1087;372;513;665;422;1;11;653;664
25;Lleida;4;Lleida;33;Segrià;25120;Lleida;1;4;;1762;605;870;1177;585;3;1;1173;1174
25;Lleida;4;Lleida;33;Segrià;25120;Lleida;1;5;;1464;473;636;831;633;4;9;818;827
25;Lleida;4;Lleida;33;Segrià;25120;Lleida;1;6;;1063;388;506;639;424;2;1;636;637
25;Lleida;4;Lleida;33;Segrià;25120;Lleida;1;7;;2056;678;907;1211;845;2;6;1203;1209
25;Lleida;4;Lleida;33;Segrià;25120;Lleida;1;8;;1860;584;866;1145;715;1;10;1134;1144
25;Lleida;4;Lleida;33;Segrià;25120;Lleida;1;9;;832;273;389;495;337;0;1;494;495
25;Lleida;4;Lleida;33;Segrià;25120;Lleida;2;2;;1158;395;554;691;467;7;2;682;684
25;Lleida;4;Lleida;33;Segrià;25120;Lleida;2;3;;885;286;409;546;339;3;8;535;543
25;Lleida;4;Lleida;33;Segrià;25120;Lleida;2;4;;2160;700;986;1375;785;4;5;1366;1371
25;Lleida;4;Lleida;33;Segrià;25120;Lleida;2;5;;2017;707;1048;1366;651;2;10;1354;1364
25;Lleida;4;Lleida;33;Segrià;25120;Lleida;2;6;;848;311;416;519;329;2;5;512;517
25;Lleida;4;Lleida;33;Segrià;25120;Lleida;2;7;;1413;487;667;880;533;4;10;866;876
25;Lleida;4;Lleida;33;Segrià;25120;Lleida;2;8;;884;295;397;497;387;4;2;491;493
25;Lleida;4;Lleida;33;Segrià;25120;Lleida;2;9;;1535;552;791;1109;426;3;14;1092;1106
25;Lleida;4;Lleida;33;Segrià;25120;Lleida;3;1;;676;217;285;358;318;0;1;357;358
25;Lleida;4;Lleida;33;Segrià;25120;Lleida;3;3;;978;341;450;572;406;2;9;561;570
25;Lleida;4;Lleida;33;Segrià;25120;Lleida;3;4;;1055;425;548;747;308;1;5;741;746
25;Lleida;4;Lleida;33;Segrià;25120;Lleida;3;5;;490;198;261;333;157;1;2;330;332
25;Lleida;4;Lleida;33;Segrià;25120;Lleida;3;6;;1067;382;527;674;393;1;6;667;673
25;Lleida;4;Lleida;33;Segrià;25120;Lleida;3;7;;572;177;242;347;225;3;0;344;344
25;Lleida;4;Lleida;33;Segrià;25120;Lleida;3;8;;762;278;383;498;264;1;2;495;497
25;Lleida;4;Lleida;33;Segrià;25120;Lleida;4;1;;1051;210;303;402;649;1;2;399;401
25;Lleida;4;Lleida;33;Segrià;25120;Lleida;4;10;;1239;231;340;425;814;5;5;415;420
25;Lleida;4;Lleida;33;Segrià;25120;Lleida;4;11;;1318;237;347;426;892;5;3;418;421
25;Lleida;4;Lleida;33;Segrià;25120;Lleida;4;13;;823;256;328;421;402;7;1;413;414
25;Lleida;4;Lleida;33;Segrià;25120;Lleida;4;14;;1095;312;434;597;498;5;3;589;592
25;Lleida;4;Lleida;33;Segrià;25120;Lleida;4;15;;965;328;439;562;403;1;5;556;561
25;Lleida;4;Lleida;33;Segrià;25120;Lleida;4;16;;975;340;462;610;365;6;2;602;604
25;Lleida;4;Lleida;33;Segrià;25120;Lleida;4;17;;1178;431;552;733;445;2;6;725;731
25;Lleida;4;Lleida;33;Segrià;25120;Lleida;4;3;;1461;555;763;994;467;5;4;985;989
25;Lleida;4;Lleida;33;Segrià;25120;Lleida;4;4;;626;223;288;372;254;3;7;362;369
25;Lleida;4;Lleida;33;Segrià;25120;Lleida;4;5;;587;217;275;365;222;4;2;359;361
25;Lleida;4;Lleida;33;Segrià;25120;Lleida;4;6;;1049;386;517;674;375;4;6;664;670
25;Lleida;4;Lleida;33;Segrià;25120;Lleida;4;7;;847;300;401;495;352;3;3;489;492
25;Lleida;4;Lleida;33;Segrià;25120;Lleida;4;8;;678;227;280;360;318;1;1;358;359
25;Lleida;4;Lleida;33;Segrià;25120;Lleida;5;10;;738;288;387;498;240;3;6;489;495
25;Lleida;4;Lleida;33;Segrià;25120;Lleida;5;11;;1380;595;808;1096;284;0;13;1083;1096
25;Lleida;4;Lleida;33;Segrià;25120;Lleida;5;12;;736;295;400;505;231;0;5;500;505
25;Lleida;4;Lleida;33;Segrià;25120;Lleida;5;2;;745;285;386;484;261;6;3;475;478
25;Lleida;4;Lleida;33;Segrià;25120;Lleida;5;3;;913;317;446;583;330;2;9;572;581
25;Lleida;4;Lleida;33;Segrià;25120;Lleida;5;4;;803;275;392;520;283;3;2;515;517
25;Lleida;4;Lleida;33;Segrià;25120;Lleida;5;5;;843;333;432;557;286;4;7;546;553
25;Lleida;4;Lleida;33;Segrià;25120;Lleida;5;6;;1329;508;713;957;372;2;4;951;955
25;Lleida;4;Lleida;33;Segrià;25120;Lleida;5;7;;562;186;246;303;259;1;1;301;302
25;Lleida;4;Lleida;33;Segrià;25120;Lleida;5;8;;860;332;477;608;252;1;6;601;607
25;Lleida;4;Lleida;33;Segrià;25120;Lleida;5;9;;729;284;392;494;235;1;1;492;493
25;Lleida;4;Lleida;33;Segrià;25120;Lleida;6;1;;1111;337;437;554;557;4;6;544;550
25;Lleida;4;Lleida;33;Segrià;25120;Lleida;6;10;;964;282;390;524;440;7;5;512;517
25;Lleida;4;Lleida;33;Segrià;25120;Lleida;6;11;;974;361;475;632;342;1;2;629;631
25;Lleida;4;Lleida;33;Segrià;25120;Lleida;6;12;;989;351;473;625;364;0;3;622;625
25;Lleida;4;Lleida;33;Segrià;25120;Lleida;6;13;;909;339;474;631;278;0;2;629;631
25;Lleida;4;Lleida;33;Segrià;25120;Lleida;6;14;;1684;609;851;1122;562;5;9;1108;1117
25;Lleida;4;Lleida;33;Segrià;25120;Lleida;6;16;;711;259;374;514;197;0;2;512;514
25;Lleida;4;Lleida;33;Segrià;25120;Lleida;6;17;;1423;449;635;763;660;3;3;757;760
25;Lleida;4;Lleida;33;Segrià;25120;Lleida;6;2;;1064;411;519;629;435;0;3;626;629
25;Lleida;4;Lleida;33;Segrià;25120;Lleida;6;3;;1337;446;591;758;579;1;4;753;757
25;Lleida;4;Lleida;33;Segrià;25120;Lleida;6;4;;1382;532;719;902;480;5;4;893;897
25;Lleida;4;Lleida;33;Segrià;25120;Lleida;6;5;;538;230;293;374;164;2;1;371;372
25;Lleida;4;Lleida;33;Segrià;25120;Lleida;6;6;;998;302;439;563;435;2;3;558;561
25;Lleida;4;Lleida;33;Segrià;25120;Lleida;6;7;;1647;513;712;925;722;2;5;918;923
25;Lleida;4;Lleida;33;Segrià;25120;Lleida;6;9;;1631;551;749;941;690;2;6;933;939
25;Lleida;4;Lleida;33;Segrià;25120;Lleida;7;1;;1905;652;895;1195;710;3;10;1182;1192
25;Lleida;4;Lleida;33;Segrià;25120;Lleida;7;2;;1210;362;510;659;551;4;2;653;655
25;Lleida;4;Lleida;33;Segrià;25120;Lleida;7;3;;1449;472;683;857;592;7;9;841;850
25;Lleida;4;Lleida;33;Segrià;25120;Lleida;7;4;;2018;514;720;935;1083;3;6;926;932
25;Lleida;4;Lleida;33;Segrià;25120;Lleida;7;5;;1874;568;799;1024;850;1;4;1019;1023
25;Lleida;4;Lleida;33;Segrià;25120;Lleida;7;6;;1626;488;714;913;713;2;2;909;911
25;Lleida;4;Lleida;33;Segrià;25120;Lleida;7;7;;1579;496;690;881;698;2;4;875;879
25;Lleida;4;Lleida;33;Segrià;25120;Lleida;8;1;;1108;376;537;677;431;3;4;670;674
25;Lleida;4;Lleida;33;Segrià;25120;Lleida;8;2;;1553;585;887;1195;358;2;6;1187;1193
25;Lleida;4;Lleida;33;Segrià;25120;Lleida;8;3;;824;307;436;583;241;5;2;576;578
25;Lleida;4;Lleida;33;Segrià;25120;Lleida;8;4;;811;274;407;517;294;1;5;511;516
25;Lleida;4;Lleida;33;Segrià;25120;Lleida;9;1;;1496;485;714;1010;486;5;14;991;1005
25;Lleida;4;Lleida;33;Segrià;25120;Lleida;9;2;;1147;386;523;675;472;3;1;671;672
17;Girona;3;Girona;2;Alt Empordà;17093;Llers;1;1;;928;360;520;654;274;7;25;622;647
25;Lleida;5;Alt Pirineu i territori d'Aran;15;Cerdanya;25127;Lles de Cerdanya;1;1;;219;80;119;151;68;9;12;130;142
8;Barcelona;1;Barcelona;41;Vallès Oriental;08107;Lliçà d'Amunt;1;1;;1554;500;751;1018;536;3;8;1007;1015
8;Barcelona;1;Barcelona;41;Vallès Oriental;08107;Lliçà d'Amunt;1;10;;1124;358;494;623;501;3;4;616;620
8;Barcelona;1;Barcelona;41;Vallès Oriental;08107;Lliçà d'Amunt;1;2;;1119;353;543;722;397;4;9;709;718
8;Barcelona;1;Barcelona;41;Vallès Oriental;08107;Lliçà d'Amunt;1;3;;1002;260;390;581;421;1;2;578;580
8;Barcelona;1;Barcelona;41;Vallès Oriental;08107;Lliçà d'Amunt;1;4;;1461;502;680;835;626;5;4;826;830
8;Barcelona;1;Barcelona;41;Vallès Oriental;08107;Lliçà d'Amunt;1;5;;1299;396;623;795;504;0;8;787;795
8;Barcelona;1;Barcelona;41;Vallès Oriental;08107;Lliçà d'Amunt;1;6;;860;263;392;496;364;3;3;490;493
8;Barcelona;1;Barcelona;41;Vallès Oriental;08107;Lliçà d'Amunt;1;7;;1307;419;764;815;492;0;4;811;815
8;Barcelona;1;Barcelona;41;Vallès Oriental;08107;Lliçà d'Amunt;1;8;;1181;349;582;692;489;3;0;689;689
8;Barcelona;1;Barcelona;41;Vallès Oriental;08107;Lliçà d'Amunt;1;9;;1017;356;504;621;396;2;3;616;619
8;Barcelona;1;Barcelona;41;Vallès Oriental;08108;Lliçà de Vall;1;1;;1547;565;779;981;566;2;13;966;979
8;Barcelona;1;Barcelona;41;Vallès Oriental;08108;Lliçà de Vall;1;2;;1446;514;760;955;491;5;4;946;950
8;Barcelona;1;Barcelona;41;Vallès Oriental;08108;Lliçà de Vall;1;3;;1325;519;719;894;431;3;9;882;891
8;Barcelona;1;Barcelona;41;Vallès Oriental;08108;Lliçà de Vall;1;4;;888;340;491;586;302;3;6;577;583
25;Lleida;5;Alt Pirineu i territori d'Aran;25;Pallars Jussà;25128;Llimiana;1;1;;128;49;67;95;33;1;0;94;94
8;Barcelona;1;Barcelona;41;Vallès Oriental;08106;Llinars del Vallès;1;1;;1138;413;559;688;450;3;14;671;685
8;Barcelona;1;Barcelona;41;Vallès Oriental;08106;Llinars del Vallès;1;2;;1526;539;736;939;587;12;15;912;927
8;Barcelona;1;Barcelona;41;Vallès Oriental;08106;Llinars del Vallès;2;1;;1557;619;855;1073;484;4;12;1057;1069
8;Barcelona;1;Barcelona;41;Vallès Oriental;08106;Llinars del Vallès;2;2;;1083;482;634;758;325;2;20;736;756
8;Barcelona;1;Barcelona;41;Vallès Oriental;08106;Llinars del Vallès;2;3;;1189;419;492;741;448;3;12;726;738
8;Barcelona;1;Barcelona;41;Vallès Oriental;08106;Llinars del Vallès;2;4;;1026;341;476;608;418;33;5;570;575
17;Girona;5;Alt Pirineu i territori d'Aran;15;Cerdanya;17094;Llívia;1;1;;1098;399;583;755;343;14;24;717;741
43;Tarragona;6;Camp de Tarragona;29;Priorat;43072;Lloar, el;1;1;;92;38;49;63;29;1;3;59;62
25;Lleida;2;Catalunya Central;35;Solsonès;25129;Llobera;1;1;;159;56;86;119;40;2;4;113;117
43;Tarragona;6;Camp de Tarragona;16;Conca de Barberà;43073;Llorac;1;1;;84;37;45;67;17;2;0;65;65
43;Tarragona;8;Penedès;12;Baix Penedès;43074;Llorenç del Penedès;1;1;;1817;721;968;1229;588;13;29;1187;1216
17;Girona;3;Girona;34;Selva;17095;Lloret de Mar;1;1;;1625;449;641;826;799;4;5;817;822
17;Girona;3;Girona;34;Selva;17095;Lloret de Mar;1;2;;1244;399;563;698;546;9;7;682;689
17;Girona;3;Girona;34;Selva;17095;Lloret de Mar;1;3;;2304;534;766;989;1315;3;12;974;986
17;Girona;3;Girona;34;Selva;17095;Lloret de Mar;2;1;;1417;471;634;843;574;5;14;824;838
17;Girona;3;Girona;34;Selva;17095;Lloret de Mar;2;2;;1332;450;678;785;547;11;14;760;774
17;Girona;3;Girona;34;Selva;17095;Lloret de Mar;2;3;;1679;499;722;887;792;9;9;869;878
17;Girona;3;Girona;34;Selva;17095;Lloret de Mar;3;1;;1562;463;705;920;642;5;1;914;915
17;Girona;3;Girona;34;Selva;17095;Lloret de Mar;3;2;;1999;612;891;1102;897;10;11;1081;1092
17;Girona;3;Girona;34;Selva;17095;Lloret de Mar;3;3;;1820;561;859;1096;724;7;8;1081;1089
17;Girona;3;Girona;34;Selva;17095;Lloret de Mar;3;4;;1538;458;623;770;768;2;7;761;768
17;Girona;3;Girona;34;Selva;17095;Lloret de Mar;4;1;;1555;409;599;729;826;2;4;723;727
17;Girona;3;Girona;34;Selva;17095;Lloret de Mar;4;2;;1536;412;624;858;678;0;7;851;858
17;Girona;3;Girona;34;Selva;17095;Lloret de Mar;4;3;;1190;414;603;752;438;5;3;744;747
17;Girona;3;Girona;34;Selva;17095;Lloret de Mar;4;4;;794;233;360;492;302;3;6;483;489
17;Girona;3;Girona;31;Ripollès;17096;Llosses, les;1;1;;166;48;89;119;47;2;9;108;117
8;Barcelona;2;Catalunya Central;24;Osona;08109;Lluçà;1;1;;212;88;138;176;36;14;49;113;162
17;Girona;3;Girona;2;Alt Empordà;17102;Maçanet de Cabrenys;1;1;;569;236;340;414;155;20;75;319;394
17;Girona;3;Girona;34;Selva;17103;Maçanet de la Selva;1;1;;1112;498;670;804;308;2;7;795;802
17;Girona;3;Girona;34;Selva;17103;Maçanet de la Selva;1;2;;1789;581;802;967;822;1;9;957;966
17;Girona;3;Girona;34;Selva;17103;Maçanet de la Selva;1;3;;1137;414;589;729;408;6;5;718;723
17;Girona;3;Girona;34;Selva;17103;Maçanet de la Selva;1;4;;1098;333;440;543;555;6;11;526;537
17;Girona;3;Girona;20;Gironès;17097;Madremanya;1;1;;218;81;115;161;57;6;13;142;155
17;Girona;3;Girona;19;Garrotxa;17098;Maià de Montcal;1;1;;317;137;169;211;106;9;51;151;202
25;Lleida;4;Lleida;33;Segrià;25133;Maials;1;1;;694;305;442;561;133;23;15;523;538
25;Lleida;4;Lleida;38;Urgell;25130;Maldà;1;1;;189;96;132;165;24;6;2;157;159
8;Barcelona;1;Barcelona;21;Maresme;08110;Malgrat de Mar;1;1;;1209;505;658;830;379;3;11;816;827
8;Barcelona;1;Barcelona;21;Maresme;08110;Malgrat de Mar;1;2;;1958;749;1010;1264;694;7;5;1252;1257
8;Barcelona;1;Barcelona;21;Maresme;08110;Malgrat de Mar;1;3;;1674;621;803;1025;649;0;8;1017;1025
8;Barcelona;1;Barcelona;21;Maresme;08110;Malgrat de Mar;1;4;;1376;507;703;872;504;9;7;856;863
8;Barcelona;1;Barcelona;21;Maresme;08110;Malgrat de Mar;1;5;;1324;455;683;819;505;4;4;811;815
8;Barcelona;1;Barcelona;21;Maresme;08110;Malgrat de Mar;1;6;;1803;624;862;1076;727;2;6;1068;1074
8;Barcelona;1;Barcelona;21;Maresme;08110;Malgrat de Mar;2;1;;1334;520;755;926;408;9;19;898;917
8;Barcelona;1;Barcelona;21;Maresme;08110;Malgrat de Mar;2;2;;1671;699;958;1117;554;6;13;1098;1111
8;Barcelona;1;Barcelona;21;Maresme;08110;Malgrat de Mar;2;3;;1369;501;652;775;594;1;6;768;774
8;Barcelona;2;Catalunya Central;24;Osona;08111;Malla;1;1;;217;97;150;193;24;0;11;182;193
8;Barcelona;2;Catalunya Central;24;Osona;08112;Manlleu;1;1;;1452;513;781;993;459;11;15;967;982
8;Barcelona;2;Catalunya Central;24;Osona;08112;Manlleu;1;2;;694;244;348;427;267;9;11;407;418
8;Barcelona;2;Catalunya Central;24;Osona;08112;Manlleu;2;1;;1196;483;680;855;341;3;8;844;852
8;Barcelona;2;Catalunya Central;24;Osona;08112;Manlleu;2;2;;1206;413;612;789;417;9;21;759;780
8;Barcelona;2;Catalunya Central;24;Osona;08112;Manlleu;2;3;;785;307;417;531;254;3;12;516;528
8;Barcelona;2;Catalunya Central;24;Osona;08112;Manlleu;2;4;;966;342;484;610;356;3;8;599;607
8;Barcelona;2;Catalunya Central;24;Osona;08112;Manlleu;3;1;;1086;374;513;664;422;5;7;652;659
8;Barcelona;2;Catalunya Central;24;Osona;08112;Manlleu;3;2;;1290;458;666;826;464;4;15;807;822
8;Barcelona;2;Catalunya Central;24;Osona;08112;Manlleu;3;3;;1114;352;507;625;489;5;7;613;620
8;Barcelona;2;Catalunya Central;24;Osona;08112;Manlleu;3;4;;1201;353;529;734;467;3;11;720;731
8;Barcelona;2;Catalunya Central;24;Osona;08112;Manlleu;4;1;;614;235;335;415;199;0;8;407;415
8;Barcelona;2;Catalunya Central;24;Osona;08112;Manlleu;4;2;;1381;516;749;972;409;5;15;952;967
8;Barcelona;2;Catalunya Central;7;Bages;08113;Manresa;1;1;;628;196;273;358;270;3;1;354;355
8;Barcelona;2;Catalunya Central;7;Bages;08113;Manresa;1;2;;545;174;245;307;238;3;6;298;304
8;Barcelona;2;Catalunya Central;7;Bages;08113;Manresa;2;1;;617;249;352;433;184;2;3;428;431
8;Barcelona;2;Catalunya Central;7;Bages;08113;Manresa;2;10;;1266;484;679;859;407;2;8;849;857
8;Barcelona;2;Catalunya Central;7;Bages;08113;Manresa;2;11;;1341;508;713;904;437;4;6;894;900
8;Barcelona;2;Catalunya Central;7;Bages;08113;Manresa;2;12;;1045;373;539;727;318;3;3;721;724
8;Barcelona;2;Catalunya Central;7;Bages;08113;Manresa;2;13;;1003;397;477;611;392;3;3;605;608
8;Barcelona;2;Catalunya Central;7;Bages;08113;Manresa;2;14;;704;243;341;434;270;0;4;430;434
8;Barcelona;2;Catalunya Central;7;Bages;08113;Manresa;2;2;;1594;600;841;1093;501;3;11;1079;1090
8;Barcelona;2;Catalunya Central;7;Bages;08113;Manresa;2;3;;1396;521;730;952;444;1;9;942;951
8;Barcelona;2;Catalunya Central;7;Bages;08113;Manresa;2;4;;1517;529;779;1006;511;1;11;994;1005
8;Barcelona;2;Catalunya Central;7;Bages;08113;Manresa;2;5;;1563;582;823;1006;557;4;6;996;1002
8;Barcelona;2;Catalunya Central;7;Bages;08113;Manresa;2;6;;567;174;245;322;245;0;2;320;322
8;Barcelona;2;Catalunya Central;7;Bages;08113;Manresa;2;7;;1022;367;496;621;401;1;5;615;620
8;Barcelona;2;Catalunya Central;7;Bages;08113;Manresa;2;8;;680;203;300;392;288;5;0;387;387
8;Barcelona;2;Catalunya Central;7;Bages;08113;Manresa;2;9;;1202;388;567;740;462;4;0;736;736
8;Barcelona;2;Catalunya Central;7;Bages;08113;Manresa;3;1;;672;222;320;390;282;1;0;389;389
8;Barcelona;2;Catalunya Central;7;Bages;08113;Manresa;3;2;;588;201;292;350;238;4;1;345;346
8;Barcelona;2;Catalunya Central;7;Bages;08113;Manresa;3;4;;924;274;406;525;399;1;5;519;524
8;Barcelona;2;Catalunya Central;7;Bages;08113;Manresa;3;5;;1634;511;794;1019;615;2;11;1006;1017
8;Barcelona;2;Catalunya Central;7;Bages;08113;Manresa;3;6;;737;254;353;435;302;1;3;431;434
8;Barcelona;2;Catalunya Central;7;Bages;08113;Manresa;4;1;;1347;477;631;811;536;0;4;807;811
8;Barcelona;2;Catalunya Central;7;Bages;08113;Manresa;4;11;;665;221;294;384;281;1;1;382;383
8;Barcelona;2;Catalunya Central;7;Bages;08113;Manresa;4;12;;770;226;340;470;300;0;7;463;470
8;Barcelona;2;Catalunya Central;7;Bages;08113;Manresa;4;13;;1059;387;559;725;334;2;2;721;723
8;Barcelona;2;Catalunya Central;7;Bages;08113;Manresa;4;14;;1362;465;685;947;415;3;8;936;944
8;Barcelona;2;Catalunya Central;7;Bages;08113;Manresa;4;15;;1778;555;860;1137;641;3;7;1127;1134
8;Barcelona;2;Catalunya Central;7;Bages;08113;Manresa;4;3;;604;228;288;367;237;1;4;362;366
8;Barcelona;2;Catalunya Central;7;Bages;08113;Manresa;4;4;;1376;461;656;880;496;4;12;864;876
8;Barcelona;2;Catalunya Central;7;Bages;08113;Manresa;4;5;;1126;394;551;726;400;2;13;711;724
8;Barcelona;2;Catalunya Central;7;Bages;08113;Manresa;4;6;;1229;410;620;792;437;3;6;783;789
8;Barcelona;2;Catalunya Central;7;Bages;08113;Manresa;4;7;;1542;502;722;983;559;1;9;973;982
8;Barcelona;2;Catalunya Central;7;Bages;08113;Manresa;4;8;;1102;426;565;707;395;1;2;704;706
8;Barcelona;2;Catalunya Central;7;Bages;08113;Manresa;4;9;;1191;454;576;727;464;2;7;718;725
8;Barcelona;2;Catalunya Central;7;Bages;08113;Manresa;5;1;;724;206;296;369;355;1;1;367;368
8;Barcelona;2;Catalunya Central;7;Bages;08113;Manresa;5;10;;1077;364;483;588;489;5;4;579;583
8;Barcelona;2;Catalunya Central;7;Bages;08113;Manresa;5;11;;1208;395;554;718;490;0;6;712;718
8;Barcelona;2;Catalunya Central;7;Bages;08113;Manresa;5;12;;676;198;280;350;326;1;4;345;349
8;Barcelona;2;Catalunya Central;7;Bages;08113;Manresa;5;13;;735;262;368;457;278;4;6;447;453
8;Barcelona;2;Catalunya Central;7;Bages;08113;Manresa;5;14;;1353;511;662;829;524;5;6;818;824
8;Barcelona;2;Catalunya Central;7;Bages;08113;Manresa;5;15;;890;317;424;509;381;4;4;501;505
8;Barcelona;2;Catalunya Central;7;Bages;08113;Manresa;5;17;;1334;426;629;866;468;2;5;859;864
8;Barcelona;2;Catalunya Central;7;Bages;08113;Manresa;5;18;;728;208;286;402;326;0;4;398;402
8;Barcelona;2;Catalunya Central;7;Bages;08113;Manresa;5;2;;882;230;342;441;441;2;2;437;439
8;Barcelona;2;Catalunya Central;7;Bages;08113;Manresa;5;3;;1056;310;462;613;443;5;10;598;608
8;Barcelona;2;Catalunya Central;7;Bages;08113;Manresa;5;4;;678;245;320;400;278;0;2;398;400
8;Barcelona;2;Catalunya Central;7;Bages;08113;Manresa;5;5;;1452;411;617;782;670;0;4;778;782
8;Barcelona;2;Catalunya Central;7;Bages;08113;Manresa;5;6;;1243;396;560;746;497;4;3;739;742
8;Barcelona;2;Catalunya Central;7;Bages;08113;Manresa;5;7;;330;102;145;178;152;0;1;177;178
8;Barcelona;2;Catalunya Central;7;Bages;08113;Manresa;5;8;;544;163;239;320;224;0;2;318;320
8;Barcelona;2;Catalunya Central;7;Bages;08113;Manresa;6;1;;670;193;276;324;346;3;4;317;321
8;Barcelona;2;Catalunya Central;7;Bages;08113;Manresa;6;2;;799;270;403;481;318;0;4;477;481
43;Tarragona;6;Camp de Tarragona;29;Priorat;43076;Marçà;1;1;;465;218;278;329;136;21;40;268;308
43;Tarragona;6;Camp de Tarragona;29;Priorat;43075;Margalef;1;1;;89;44;53;66;23;4;3;59;62
8;Barcelona;2;Catalunya Central;7;Bages;08242;Marganell;1;1;;228;123;150;184;44;0;0;184;184
8;Barcelona;1;Barcelona;11;Baix Llobregat;08114;Martorell;1;1;;1097;375;534;690;407;3;7;680;687
8;Barcelona;1;Barcelona;11;Baix Llobregat;08114;Martorell;1;2;;615;188;256;324;291;5;2;317;319
8;Barcelona;1;Barcelona;11;Baix Llobregat;08114;Martorell;1;3;;976;364;487;605;371;1;5;599;604
8;Barcelona;1;Barcelona;11;Baix Llobregat;08114;Martorell;2;3;;1806;576;768;1002;804;6;6;990;996
8;Barcelona;1;Barcelona;11;Baix Llobregat;08114;Martorell;3;10;;501;217;290;383;118;4;6;373;379
8;Barcelona;1;Barcelona;11;Baix Llobregat;08114;Martorell;3;2;;1107;384;505;621;486;3;5;613;618
8;Barcelona;1;Barcelona;11;Baix Llobregat;08114;Martorell;3;4;;1231;451;604;733;498;3;5;725;730
8;Barcelona;1;Barcelona;11;Baix Llobregat;08114;Martorell;3;5;;1076;366;484;625;451;5;3;617;620
8;Barcelona;1;Barcelona;11;Baix Llobregat;08114;Martorell;3;6;;1341;490;636;815;526;4;3;808;811
8;Barcelona;1;Barcelona;11;Baix Llobregat;08114;Martorell;3;7;;1086;457;607;791;295;4;1;786;787
8;Barcelona;1;Barcelona;11;Baix Llobregat;08114;Martorell;3;8;;1717;628;887;1188;529;8;13;1167;1180
8;Barcelona;1;Barcelona;11;Baix Llobregat;08114;Martorell;4;1;;1864;643;886;1210;654;6;14;1190;1204
8;Barcelona;1;Barcelona;11;Baix Llobregat;08114;Martorell;4;2;;1656;654;903;1170;486;3;11;1156;1167
8;Barcelona;1;Barcelona;11;Baix Llobregat;08114;Martorell;4;3;;1238;432;611;771;467;1;3;767;770
8;Barcelona;1;Barcelona;11;Baix Llobregat;08114;Martorell;4;4;;1459;540;757;977;482;5;7;965;972
8;Barcelona;1;Barcelona;41;Vallès Oriental;08115;Martorelles;1;1;;1416;475;681;856;560;5;17;834;851
8;Barcelona;1;Barcelona;41;Vallès Oriental;08115;Martorelles;1;2;;1274;500;679;888;386;9;14;865;879
8;Barcelona;1;Barcelona;41;Vallès Oriental;08115;Martorelles;1;3;;1146;354;573;715;431;5;6;704;710
17;Girona;3;Girona;2;Alt Empordà;17100;Masarac;1;1;;198;93;136;160;38;2;5;153;158
43;Tarragona;7;Terres de l'Ebre;22;Montsià;43077;Mas de Barberans;1;1;;466;206;343;363;103;10;7;346;353
43;Tarragona;7;Terres de l'Ebre;22;Montsià;43078;Masdenverge;1;1;;846;405;549;661;185;19;15;627;642
8;Barcelona;2;Catalunya Central;24;Osona;08116;Masies de Roda, les;1;1;;556;240;339;437;119;9;7;421;428
8;Barcelona;2;Catalunya Central;24;Osona;08117;Masies de Voltregà, les;1;1;;1837;776;1112;1400;437;8;28;1364;1392
8;Barcelona;2;Catalunya Central;24;Osona;08117;Masies de Voltregà, les;2;1;;646;241;363;445;201;6;9;430;439
43;Tarragona;8;Penedès;12;Baix Penedès;43079;Masllorenç;1;1;;366;203;273;318;48;2;6;310;316
8;Barcelona;1;Barcelona;21;Maresme;08118;Masnou, el;1;1;;1444;481;707;945;499;5;4;936;940
8;Barcelona;1;Barcelona;21;Maresme;08118;Masnou, el;1;10;;1406;553;781;1001;405;2;8;991;999
8;Barcelona;1;Barcelona;21;Maresme;08118;Masnou, el;1;2;;1594;592;811;1042;552;1;10;1031;1041
8;Barcelona;1;Barcelona;21;Maresme;08118;Masnou, el;1;3;;916;383;526;650;266;1;7;642;649
8;Barcelona;1;Barcelona;21;Maresme;08118;Masnou, el;1;4;;1482;565;816;1046;436;1;4;1041;1045
8;Barcelona;1;Barcelona;21;Maresme;08118;Masnou, el;1;5;;1467;566;760;996;471;4;13;979;992
8;Barcelona;1;Barcelona;21;Maresme;08118;Masnou, el;1;6;;1395;473;654;843;552;1;10;832;842
8;Barcelona;1;Barcelona;21;Maresme;08118;Masnou, el;1;7;;1199;501;676;832;367;1;5;826;831
8;Barcelona;1;Barcelona;21;Maresme;08118;Masnou, el;1;8;;1084;380;569;679;405;3;2;674;676
8;Barcelona;1;Barcelona;21;Maresme;08118;Masnou, el;1;9;;663;247;365;462;201;2;5;455;460
8;Barcelona;1;Barcelona;21;Maresme;08118;Masnou, el;2;1;;1406;575;796;992;414;2;11;979;990
8;Barcelona;1;Barcelona;21;Maresme;08118;Masnou, el;2;2;;954;321;466;642;312;1;0;641;641
8;Barcelona;1;Barcelona;21;Maresme;08118;Masnou, el;2;3;;1179;475;634;829;350;6;4;819;823
8;Barcelona;1;Barcelona;21;Maresme;08118;Masnou, el;2;4;;1599;590;816;1060;539;3;8;1049;1057
43;Tarragona;6;Camp de Tarragona;1;Alt Camp;43080;Masó, la;1;1;;226;106;145;176;50;10;25;141;166
43;Tarragona;6;Camp de Tarragona;8;Baix Camp;43081;Maspujols;1;1;;637;258;392;485;152;7;15;463;478
8;Barcelona;8;Penedès;6;Anoia;08119;Masquefa;1;1;;3855;1583;2149;2651;1204;11;18;2622;2640
8;Barcelona;8;Penedès;6;Anoia;08119;Masquefa;1;2;;2999;1063;1451;1785;1214;10;11;1764;1775
43;Tarragona;6;Camp de Tarragona;29;Priorat;43082;Masroig, el;1;1;;361;197;259;318;43;7;7;304;311
25;Lleida;4;Lleida;33;Segrià;25131;Massalcoreig;1;1;;399;147;233;287;112;17;41;229;270
17;Girona;3;Girona;34;Selva;17101;Massanes;1;1;;572;238;341;409;163;0;7;402;409
25;Lleida;4;Lleida;32;Segarra;25132;Massoteres;1;1;;142;80;105;122;20;1;0;121;121
8;Barcelona;1;Barcelona;40;Vallès Occidental;08120;Matadepera;1;1;;1977;569;948;1377;600;7;27;1343;1370
8;Barcelona;1;Barcelona;40;Vallès Occidental;08120;Matadepera;1;2;;1879;560;939;1326;553;3;8;1315;1323
8;Barcelona;1;Barcelona;40;Vallès Occidental;08120;Matadepera;1;3;;1846;591;908;1243;603;7;11;1225;1236
8;Barcelona;1;Barcelona;40;Vallès Occidental;08120;Matadepera;1;4;;1418;459;732;962;456;2;21;939;960
8;Barcelona;1;Barcelona;21;Maresme;08121;Mataró;1;1;;1262;507;709;895;367;2;5;888;893
8;Barcelona;1;Barcelona;21;Maresme;08121;Mataró;1;2;;1291;472;683;874;417;2;6;866;872
8;Barcelona;1;Barcelona;21;Maresme;08121;Mataró;1;3;;1139;561;747;805;334;1;2;802;804
8;Barcelona;1;Barcelona;21;Maresme;08121;Mataró;1;4;;1105;505;687;869;236;0;4;865;869
8;Barcelona;1;Barcelona;21;Maresme;08121;Mataró;1;5;;1283;538;740;936;347;1;3;932;935
8;Barcelona;1;Barcelona;21;Maresme;08121;Mataró;1;6;;1259;520;732;911;348;3;7;901;908
8;Barcelona;1;Barcelona;21;Maresme;08121;Mataró;1;7;;1391;615;823;1026;365;1;1;1024;1025
8;Barcelona;1;Barcelona;21;Maresme;08121;Mataró;1;9;;981;407;584;722;259;0;2;720;722
8;Barcelona;1;Barcelona;21;Maresme;08121;Mataró;2;1;;1793;686;1016;1318;475;3;8;1307;1315
8;Barcelona;1;Barcelona;21;Maresme;08121;Mataró;2;10;;1163;440;716;804;359;2;5;797;802
8;Barcelona;1;Barcelona;21;Maresme;08121;Mataró;2;11;;1224;520;702;872;352;3;6;863;869
8;Barcelona;1;Barcelona;21;Maresme;08121;Mataró;2;12;;968;411;544;654;314;1;2;651;653
8;Barcelona;1;Barcelona;21;Maresme;08121;Mataró;2;2;;789;292;429;538;251;1;1;536;537
8;Barcelona;1;Barcelona;21;Maresme;08121;Mataró;2;3;;874;332;472;566;308;1;3;562;565
8;Barcelona;1;Barcelona;21;Maresme;08121;Mataró;2;4;;1512;463;744;777;735;0;4;773;777
8;Barcelona;1;Barcelona;21;Maresme;08121;Mataró;2;5;;1579;545;770;947;632;0;2;945;947
8;Barcelona;1;Barcelona;21;Maresme;08121;Mataró;2;7;;1340;452;663;866;474;3;10;853;863
8;Barcelona;1;Barcelona;21;Maresme;08121;Mataró;2;8;;1167;467;672;823;344;0;3;820;823
8;Barcelona;1;Barcelona;21;Maresme;08121;Mataró;2;9;;1212;517;691;835;377;0;0;835;835
8;Barcelona;1;Barcelona;21;Maresme;08121;Mataró;3;1;;920;383;478;583;337;2;1;580;581
8;Barcelona;1;Barcelona;21;Maresme;08121;Mataró;3;10;;556;249;333;409;147;0;0;409;409
8;Barcelona;1;Barcelona;21;Maresme;08121;Mataró;3;11;;1229;477;633;795;434;5;3;787;790
8;Barcelona;1;Barcelona;21;Maresme;08121;Mataró;3;12;;1326;419;626;832;494;0;3;829;832
8;Barcelona;1;Barcelona;21;Maresme;08121;Mataró;3;13;;2287;859;1257;1529;758;1;8;1520;1528
8;Barcelona;1;Barcelona;21;Maresme;08121;Mataró;3;14;;948;346;498;638;310;1;4;633;637
8;Barcelona;1;Barcelona;21;Maresme;08121;Mataró;3;2;;829;311;365;490;339;1;4;485;489
8;Barcelona;1;Barcelona;21;Maresme;08121;Mataró;3;3;;889;317;412;493;396;1;0;492;492
8;Barcelona;1;Barcelona;21;Maresme;08121;Mataró;3;4;;1190;401;553;661;529;2;4;655;659
8;Barcelona;1;Barcelona;21;Maresme;08121;Mataró;3;5;;1016;334;455;535;481;1;0;534;534
8;Barcelona;1;Barcelona;21;Maresme;08121;Mataró;3;6;;1196;446;661;794;402;1;1;792;793
8;Barcelona;1;Barcelona;21;Maresme;08121;Mataró;3;7;;976;343;491;616;360;5;3;608;611
8;Barcelona;1;Barcelona;21;Maresme;08121;Mataró;3;8;;850;313;433;520;330;0;5;515;520
8;Barcelona;1;Barcelona;21;Maresme;08121;Mataró;3;9;;1669;633;855;1055;614;1;0;1054;1054
8;Barcelona;1;Barcelona;21;Maresme;08121;Mataró;4;1;;932;344;515;627;305;2;6;619;625
8;Barcelona;1;Barcelona;21;Maresme;08121;Mataró;4;2;;1021;341;467;557;464;2;3;552;555
8;Barcelona;1;Barcelona;21;Maresme;08121;Mataró;4;3;;717;243;341;411;306;1;3;407;410
8;Barcelona;1;Barcelona;21;Maresme;08121;Mataró;4;4;;2121;682;1076;1263;858;4;2;1257;1259
8;Barcelona;1;Barcelona;21;Maresme;08121;Mataró;4;5;;2071;683;981;1250;821;3;5;1242;1247
8;Barcelona;1;Barcelona;21;Maresme;08121;Mataró;4;6;;1208;461;627;822;386;2;5;815;820
8;Barcelona;1;Barcelona;21;Maresme;08121;Mataró;4;7;;960;272;438;537;423;0;1;536;537
8;Barcelona;1;Barcelona;21;Maresme;08121;Mataró;4;8;;1015;325;504;664;351;0;3;661;664
8;Barcelona;1;Barcelona;21;Maresme;08121;Mataró;4;9;;1517;520;708;905;612;1;5;899;904
8;Barcelona;1;Barcelona;21;Maresme;08121;Mataró;5;1;;2049;719;1028;1288;761;1;9;1278;1287
8;Barcelona;1;Barcelona;21;Maresme;08121;Mataró;5;10;;1151;332;486;571;580;8;2;561;563
8;Barcelona;1;Barcelona;21;Maresme;08121;Mataró;5;11;;993;338;459;569;424;4;1;564;565
8;Barcelona;1;Barcelona;21;Maresme;08121;Mataró;5;12;;860;343;472;575;285;1;1;573;574
8;Barcelona;1;Barcelona;21;Maresme;08121;Mataró;5;13;;1273;485;640;751;522;1;3;747;750
8;Barcelona;1;Barcelona;21;Maresme;08121;Mataró;5;15;;792;294;412;475;317;2;2;471;473
8;Barcelona;1;Barcelona;21;Maresme;08121;Mataró;5;16;;985;302;406;498;487;1;1;496;497
8;Barcelona;1;Barcelona;21;Maresme;08121;Mataró;5;17;;705;247;333;419;286;0;5;414;419
8;Barcelona;1;Barcelona;21;Maresme;08121;Mataró;5;19;;607;212;324;393;214;0;1;392;393
8;Barcelona;1;Barcelona;21;Maresme;08121;Mataró;5;2;;1352;429;597;735;617;6;1;728;729
8;Barcelona;1;Barcelona;21;Maresme;08121;Mataró;5;20;;1003;329;464;552;451;4;3;545;548
8;Barcelona;1;Barcelona;21;Maresme;08121;Mataró;5;21;;697;270;417;496;201;0;0;496;496
8;Barcelona;1;Barcelona;21;Maresme;08121;Mataró;5;3;;1267;415;624;754;513;1;1;752;753
8;Barcelona;1;Barcelona;21;Maresme;08121;Mataró;5;4;;986;297;485;586;400;1;2;583;585
8;Barcelona;1;Barcelona;21;Maresme;08121;Mataró;5;5;;713;206;321;398;315;0;5;393;398
8;Barcelona;1;Barcelona;21;Maresme;08121;Mataró;5;6;;1039;270;445;537;502;5;1;531;532
8;Barcelona;1;Barcelona;21;Maresme;08121;Mataró;5;7;;1154;456;589;709;445;2;2;705;707
8;Barcelona;1;Barcelona;21;Maresme;08121;Mataró;5;8;;860;266;360;460;400;4;2;454;456
8;Barcelona;1;Barcelona;21;Maresme;08121;Mataró;5;9;;763;278;365;432;331;1;1;430;431
8;Barcelona;1;Barcelona;21;Maresme;08121;Mataró;6;1;;1759;687;997;1219;540;3;10;1206;1216
8;Barcelona;1;Barcelona;21;Maresme;08121;Mataró;6;10;;1812;624;907;1112;700;1;5;1106;1111
8;Barcelona;1;Barcelona;21;Maresme;08121;Mataró;6;11;;1060;306;526;693;367;3;3;687;690
8;Barcelona;1;Barcelona;21;Maresme;08121;Mataró;6;12;;1242;428;615;754;488;4;3;747;750
8;Barcelona;1;Barcelona;21;Maresme;08121;Mataró;6;13;;737;289;382;425;312;0;2;423;425
8;Barcelona;1;Barcelona;21;Maresme;08121;Mataró;6;14;;1437;544;865;970;467;1;4;965;969
8;Barcelona;1;Barcelona;21;Maresme;08121;Mataró;6;2;;670;257;359;444;226;0;4;440;444
8;Barcelona;1;Barcelona;21;Maresme;08121;Mataró;6;3;;1538;631;847;1074;464;2;7;1065;1072
8;Barcelona;1;Barcelona;21;Maresme;08121;Mataró;6;4;;1183;468;644;800;383;1;3;796;799
8;Barcelona;1;Barcelona;21;Maresme;08121;Mataró;6;5;;1396;582;746;906;490;1;6;899;905
8;Barcelona;1;Barcelona;21;Maresme;08121;Mataró;6;6;;1372;603;827;987;385;1;5;981;986
8;Barcelona;1;Barcelona;21;Maresme;08121;Mataró;6;7;;1125;429;600;720;405;1;1;718;719
8;Barcelona;1;Barcelona;21;Maresme;08121;Mataró;6;8;;1361;507;748;934;427;4;6;924;930
8;Barcelona;1;Barcelona;21;Maresme;08121;Mataró;6;9;;979;264;378;475;504;3;2;470;472
8;Barcelona;8;Penedès;3;Alt Penedès;08122;Mediona;1;1;;1728;636;884;1153;575;20;30;1103;1133
25;Lleida;4;Lleida;23;Noguera;25134;Menàrguens;1;1;;611;281;390;492;119;7;14;471;485
17;Girona;5;Alt Pirineu i territori d'Aran;15;Cerdanya;17099;Meranges;1;1;;79;33;52;69;10;1;2;66;68
17;Girona;3;Girona;19;Garrotxa;17105;Mieres;1;1;;261;148;191;222;39;2;9;211;220
43;Tarragona;6;Camp de Tarragona;1;Alt Camp;43083;Milà, el;1;1;;145;80;100;136;9;2;0;134;134
25;Lleida;4;Lleida;27;Pla d'Urgell;25135;Miralcamp;1;1;;1033;429;657;815;218;15;16;784;800
43;Tarragona;7;Terres de l'Ebre;30;Ribera d'Ebre;43084;Miravet;1;1;;532;264;350;463;69;10;6;447;453
8;Barcelona;2;Catalunya Central;42;Moianès;08138;Moià;1;1;;1798;600;944;1187;611;13;26;1148;1174
8;Barcelona;2;Catalunya Central;42;Moianès;08138;Moià;1;2;;1746;564;941;1174;572;13;19;1142;1161
8;Barcelona;2;Catalunya Central;42;Moianès;08138;Moià;1;3;;911;310;491;622;289;12;10;600;610
43;Tarragona;6;Camp de Tarragona;29;Priorat;43085;Molar, el;1;1;;248;120;170;217;31;4;8;205;213
8;Barcelona;1;Barcelona;11;Baix Llobregat;08123;Molins de Rei;1;1;;940;370;523;674;266;1;6;667;673
8;Barcelona;1;Barcelona;11;Baix Llobregat;08123;Molins de Rei;1;2;;1546;572;917;1089;457;2;5;1082;1087
8;Barcelona;1;Barcelona;11;Baix Llobregat;08123;Molins de Rei;1;3;;1340;515;724;920;420;5;12;903;915
8;Barcelona;1;Barcelona;11;Baix Llobregat;08123;Molins de Rei;2;1;;2268;902;1230;1616;652;3;11;1602;1613
8;Barcelona;1;Barcelona;11;Baix Llobregat;08123;Molins de Rei;2;2;;1264;465;716;898;366;1;4;893;897
8;Barcelona;1;Barcelona;11;Baix Llobregat;08123;Molins de Rei;2;3;;1569;662;883;1106;463;2;5;1099;1104
8;Barcelona;1;Barcelona;11;Baix Llobregat;08123;Molins de Rei;2;4;;1369;462;718;916;453;2;13;901;914
8;Barcelona;1;Barcelona;11;Baix Llobregat;08123;Molins de Rei;3;1;;2656;1076;1458;1921;735;14;16;1891;1907
8;Barcelona;1;Barcelona;11;Baix Llobregat;08123;Molins de Rei;3;2;;2611;885;1415;1925;686;6;16;1903;1919
8;Barcelona;1;Barcelona;11;Baix Llobregat;08123;Molins de Rei;3;3;;1457;492;793;1080;377;2;7;1071;1078
8;Barcelona;1;Barcelona;11;Baix Llobregat;08123;Molins de Rei;3;4;;1765;594;872;1144;621;2;2;1140;1142
8;Barcelona;1;Barcelona;11;Baix Llobregat;08123;Molins de Rei;4;1;;843;262;384;499;344;1;6;492;498
25;Lleida;4;Lleida;27;Pla d'Urgell;25137;Mollerussa;1;1;;1529;539;750;968;561;8;15;945;960
25;Lleida;4;Lleida;27;Pla d'Urgell;25137;Mollerussa;1;2;;1796;633;873;1103;693;10;26;1067;1093
25;Lleida;4;Lleida;27;Pla d'Urgell;25137;Mollerussa;1;3;;784;246;343;439;345;7;10;422;432
25;Lleida;4;Lleida;27;Pla d'Urgell;25137;Mollerussa;1;4;;1645;596;873;1128;517;11;24;1093;1117
25;Lleida;4;Lleida;27;Pla d'Urgell;25137;Mollerussa;1;5;;1636;619;756;978;658;3;11;964;975
25;Lleida;4;Lleida;27;Pla d'Urgell;25137;Mollerussa;1;6;;1451;488;701;934;517;13;22;899;921
8;Barcelona;1;Barcelona;41;Vallès Oriental;08124;Mollet del Vallès;1;1;;604;209;301;372;232;3;0;369;369
8;Barcelona;1;Barcelona;41;Vallès Oriental;08124;Mollet del Vallès;1;2;;1232;407;596;741;491;6;4;731;735
8;Barcelona;1;Barcelona;41;Vallès Oriental;08124;Mollet del Vallès;1;3;;1293;477;652;778;515;2;3;773;776
8;Barcelona;1;Barcelona;41;Vallès Oriental;08124;Mollet del Vallès;1;4;;1511;617;809;1016;495;5;17;994;1011
8;Barcelona;1;Barcelona;41;Vallès Oriental;08124;Mollet del Vallès;1;5;;1291;445;612;775;516;4;4;767;771
8;Barcelona;1;Barcelona;41;Vallès Oriental;08124;Mollet del Vallès;1;6;;1507;567;745;909;598;8;5;896;901
8;Barcelona;1;Barcelona;41;Vallès Oriental;08124;Mollet del Vallès;1;7;;1190;457;601;717;473;5;1;711;712
8;Barcelona;1;Barcelona;41;Vallès Oriental;08124;Mollet del Vallès;2;1;;1464;570;777;986;478;3;10;973;983
8;Barcelona;1;Barcelona;41;Vallès Oriental;08124;Mollet del Vallès;2;2;;1293;565;743;898;395;4;3;891;894
8;Barcelona;1;Barcelona;41;Vallès Oriental;08124;Mollet del Vallès;2;3;;1603;534;727;915;688;4;0;911;911
8;Barcelona;1;Barcelona;41;Vallès Oriental;08124;Mollet del Vallès;2;4;;1072;404;550;688;384;2;2;684;686
8;Barcelona;1;Barcelona;41;Vallès Oriental;08124;Mollet del Vallès;2;5;;1080;386;503;665;415;1;6;658;664
8;Barcelona;1;Barcelona;41;Vallès Oriental;08124;Mollet del Vallès;2;6;;1077;332;442;561;516;6;4;551;555
8;Barcelona;1;Barcelona;41;Vallès Oriental;08124;Mollet del Vallès;2;7;;1539;471;666;876;663;2;1;873;874
8;Barcelona;1;Barcelona;41;Vallès Oriental;08124;Mollet del Vallès;2;8;;1206;463;661;874;332;5;6;863;869
8;Barcelona;1;Barcelona;41;Vallès Oriental;08124;Mollet del Vallès;2;9;;831;316;414;575;256;2;3;570;573
8;Barcelona;1;Barcelona;41;Vallès Oriental;08124;Mollet del Vallès;3;1;;1597;550;740;967;630;5;4;958;962
8;Barcelona;1;Barcelona;41;Vallès Oriental;08124;Mollet del Vallès;3;10;;1019;317;448;576;443;5;3;568;571
8;Barcelona;1;Barcelona;41;Vallès Oriental;08124;Mollet del Vallès;3;11;;1332;419;626;812;520;2;1;809;810
8;Barcelona;1;Barcelona;41;Vallès Oriental;08124;Mollet del Vallès;3;12;;1357;477;674;821;536;3;6;812;818
8;Barcelona;1;Barcelona;41;Vallès Oriental;08124;Mollet del Vallès;3;13;;1213;443;586;741;472;1;3;737;740
8;Barcelona;1;Barcelona;41;Vallès Oriental;08124;Mollet del Vallès;3;14;;1142;363;506;676;466;2;1;673;674
8;Barcelona;1;Barcelona;41;Vallès Oriental;08124;Mollet del Vallès;3;15;;965;313;422;554;411;1;2;551;553
8;Barcelona;1;Barcelona;41;Vallès Oriental;08124;Mollet del Vallès;3;2;;1275;462;613;802;473;3;5;794;799
8;Barcelona;1;Barcelona;41;Vallès Oriental;08124;Mollet del Vallès;3;3;;879;345;484;581;298;0;3;578;581
8;Barcelona;1;Barcelona;41;Vallès Oriental;08124;Mollet del Vallès;3;4;;1418;500;696;885;533;0;6;879;885
8;Barcelona;1;Barcelona;41;Vallès Oriental;08124;Mollet del Vallès;3;5;;1578;575;837;1048;530;2;6;1040;1046
8;Barcelona;1;Barcelona;41;Vallès Oriental;08124;Mollet del Vallès;3;6;;879;264;353;415;464;2;1;412;413
8;Barcelona;1;Barcelona;41;Vallès Oriental;08124;Mollet del Vallès;3;7;;1413;453;629;744;669;4;4;736;740
8;Barcelona;1;Barcelona;41;Vallès Oriental;08124;Mollet del Vallès;3;8;;661;225;337;389;272;0;3;386;389
8;Barcelona;1;Barcelona;41;Vallès Oriental;08124;Mollet del Vallès;3;9;;745;274;358;446;299;0;1;445;446
17;Girona;3;Girona;2;Alt Empordà;17106;Mollet de Peralada;1;1;;148;73;98;127;21;0;2;125;127
17;Girona;3;Girona;31;Ripollès;17107;Molló;1;1;;270;95;140;198;72;7;18;173;191
25;Lleida;2;Catalunya Central;35;Solsonès;25136;Molsosa, la;1;1;;97;42;58;84;13;1;13;70;83
8;Barcelona;2;Catalunya Central;42;Moianès;08128;Monistrol de Calders;1;1;;584;278;379;472;112;6;12;454;466
8;Barcelona;2;Catalunya Central;7;Bages;08127;Monistrol de Montserrat;1;1;;654;306;416;465;189;2;3;460;463
8;Barcelona;2;Catalunya Central;7;Bages;08127;Monistrol de Montserrat;1;2;;1597;525;762;1004;593;8;8;988;996
17;Girona;3;Girona;19;Garrotxa;17109;Montagut i Oix;1;1;;711;232;327;470;241;15;43;412;455
43;Tarragona;6;Camp de Tarragona;16;Conca de Barberà;43086;Montblanc;1;1;;1000;372;502;658;342;23;16;619;635
43;Tarragona;6;Camp de Tarragona;16;Conca de Barberà;43086;Montblanc;2;1;;1388;563;823;1038;350;37;29;972;1001
43;Tarragona;6;Camp de Tarragona;16;Conca de Barberà;43086;Montblanc;2;2;;1825;737;971;1217;608;26;27;1164;1191
43;Tarragona;6;Camp de Tarragona;16;Conca de Barberà;43086;Montblanc;2;3;;1099;446;615;799;300;27;21;751;772
43;Tarragona;6;Camp de Tarragona;8;Baix Camp;43088;Montbrió del Camp;1;1;;1005;376;546;674;331;6;27;641;668
43;Tarragona;6;Camp de Tarragona;8;Baix Camp;43088;Montbrió del Camp;1;2;;1054;351;519;657;397;13;21;623;644
8;Barcelona;1;Barcelona;40;Vallès Occidental;08125;Montcada i Reixac;1;1;;841;347;460;565;276;4;1;560;561
8;Barcelona;1;Barcelona;40;Vallès Occidental;08125;Montcada i Reixac;1;2;;1104;398;584;733;371;5;2;726;728
8;Barcelona;1;Barcelona;40;Vallès Occidental;08125;Montcada i Reixac;1;4;;1310;484;668;817;493;0;4;813;817
8;Barcelona;1;Barcelona;40;Vallès Occidental;08125;Montcada i Reixac;1;5;;1143;407;573;738;405;0;4;734;738
8;Barcelona;1;Barcelona;40;Vallès Occidental;08125;Montcada i Reixac;2;1;;968;260;347;447;521;4;1;442;443
8;Barcelona;1;Barcelona;40;Vallès Occidental;08125;Montcada i Reixac;2;2;;1830;705;792;1181;649;2;6;1173;1179
8;Barcelona;1;Barcelona;40;Vallès Occidental;08125;Montcada i Reixac;2;3;;1770;624;933;1199;571;4;4;1191;1195
8;Barcelona;1;Barcelona;40;Vallès Occidental;08125;Montcada i Reixac;3;1;;1859;599;857;1056;803;6;8;1042;1050
8;Barcelona;1;Barcelona;40;Vallès Occidental;08125;Montcada i Reixac;3;2;;887;264;406;506;381;0;4;502;506
8;Barcelona;1;Barcelona;40;Vallès Occidental;08125;Montcada i Reixac;3;3;;1724;555;815;1007;717;5;5;997;1002
8;Barcelona;1;Barcelona;40;Vallès Occidental;08125;Montcada i Reixac;3;4;;1461;500;730;950;511;0;9;941;950
8;Barcelona;1;Barcelona;40;Vallès Occidental;08125;Montcada i Reixac;3;5;;1496;470;676;912;584;2;3;907;910
8;Barcelona;1;Barcelona;40;Vallès Occidental;08125;Montcada i Reixac;3;6;;956;266;392;597;359;1;5;591;596
8;Barcelona;1;Barcelona;40;Vallès Occidental;08125;Montcada i Reixac;4;1;;782;245;340;456;326;1;6;449;455
8;Barcelona;1;Barcelona;40;Vallès Occidental;08125;Montcada i Reixac;4;2;;763;266;389;488;275;1;8;479;487
8;Barcelona;1;Barcelona;40;Vallès Occidental;08125;Montcada i Reixac;4;3;;957;287;457;558;399;1;6;551;557
8;Barcelona;1;Barcelona;40;Vallès Occidental;08125;Montcada i Reixac;5;1;;1551;460;639;807;744;5;6;796;802
8;Barcelona;1;Barcelona;40;Vallès Occidental;08125;Montcada i Reixac;5;2;;964;312;440;530;434;1;3;526;529
8;Barcelona;1;Barcelona;40;Vallès Occidental;08125;Montcada i Reixac;5;3;;935;278;386;456;479;7;1;448;449
8;Barcelona;1;Barcelona;40;Vallès Occidental;08125;Montcada i Reixac;6;1;;710;193;297;444;266;6;1;437;438
8;Barcelona;1;Barcelona;40;Vallès Occidental;08125;Montcada i Reixac;6;2;;630;194;322;401;229;1;0;400;400
8;Barcelona;1;Barcelona;40;Vallès Occidental;08125;Montcada i Reixac;6;3;;920;291;383;454;466;2;1;451;452
8;Barcelona;2;Catalunya Central;14;Berguedà;08130;Montclar;1;1;;109;47;70;93;16;1;2;90;92
25;Lleida;5;Alt Pirineu i territori d'Aran;15;Cerdanya;25139;Montellà i Martinet;1;1;;491;184;300;359;132;11;43;305;348
8;Barcelona;2;Catalunya Central;24;Osona;08131;Montesquiu;1;1;;745;350;488;562;183;5;10;547;557
25;Lleida;5;Alt Pirineu i territori d'Aran;4;Alt Urgell;25140;Montferrer i Castellbò;1;1;;787;316;438;567;220;3;14;550;564
43;Tarragona;6;Camp de Tarragona;1;Alt Camp;43089;Montferri;1;1;;290;106;133;167;123;8;40;119;159
25;Lleida;4;Lleida;23;Noguera;25138;Montgai;1;1;;554;295;389;486;68;1;10;475;485
8;Barcelona;1;Barcelona;21;Maresme;08126;Montgat;1;1;;2739;876;1299;1788;951;6;12;1770;1782
8;Barcelona;1;Barcelona;21;Maresme;08126;Montgat;1;2;;2474;849;1207;1565;909;7;12;1546;1558
8;Barcelona;1;Barcelona;21;Maresme;08126;Montgat;1;3;;2307;882;1232;1495;812;7;13;1475;1488
8;Barcelona;1;Barcelona;21;Maresme;08126;Montgat;1;4;;1451;497;739;926;525;2;8;916;924
8;Barcelona;2;Catalunya Central;14;Berguedà;08132;Montmajor;1;1;;362;136;232;287;75;2;3;282;285
8;Barcelona;8;Penedès;6;Anoia;08133;Montmaneu;1;1;;128;54;83;106;22;0;0;106;106
43;Tarragona;8;Penedès;12;Baix Penedès;43090;Montmell, el;1;1;;1183;480;607;736;447;1;5;730;735
8;Barcelona;1;Barcelona;41;Vallès Oriental;08135;Montmeló;1;1;;1956;776;1121;1429;527;3;11;1415;1426
8;Barcelona;1;Barcelona;41;Vallès Oriental;08135;Montmeló;1;2;;1151;456;616;785;366;1;6;778;784
8;Barcelona;1;Barcelona;41;Vallès Oriental;08135;Montmeló;1;3;;1802;673;980;1263;539;8;14;1241;1255
8;Barcelona;1;Barcelona;41;Vallès Oriental;08135;Montmeló;1;4;;911;361;510;647;264;3;5;639;644
8;Barcelona;1;Barcelona;41;Vallès Oriental;08135;Montmeló;1;5;;957;401;543;688;269;0;9;679;688
25;Lleida;4;Lleida;33;Segrià;25142;Montoliu de Lleida;1;1;;366;150;225;306;60;3;12;291;303
25;Lleida;4;Lleida;32;Segarra;25141;Montoliu de Segarra;1;1;;151;76;97;126;25;11;1;114;115
8;Barcelona;1;Barcelona;41;Vallès Oriental;08136;Montornès del Vallès;1;1;;1422;488;688;887;535;4;10;873;883
8;Barcelona;1;Barcelona;41;Vallès Oriental;08136;Montornès del Vallès;1;2;;1231;497;660;807;424;3;9;795;804
8;Barcelona;1;Barcelona;41;Vallès Oriental;08136;Montornès del Vallès;1;3;;1791;613;886;1153;638;16;3;1134;1137
8;Barcelona;1;Barcelona;41;Vallès Oriental;08136;Montornès del Vallès;1;4;;1497;603;785;1002;495;10;12;980;992
8;Barcelona;1;Barcelona;41;Vallès Oriental;08136;Montornès del Vallès;1;5;;1793;597;879;1152;641;4;16;1132;1148
8;Barcelona;1;Barcelona;41;Vallès Oriental;08136;Montornès del Vallès;1;6;;1128;420;600;794;334;8;8;778;786
8;Barcelona;1;Barcelona;41;Vallès Oriental;08136;Montornès del Vallès;1;7;;733;283;392;486;247;7;3;476;479
8;Barcelona;1;Barcelona;41;Vallès Oriental;08136;Montornès del Vallès;2;1;;578;170;228;275;303;0;0;275;275
8;Barcelona;1;Barcelona;41;Vallès Oriental;08136;Montornès del Vallès;2;2;;676;218;328;410;266;3;1;406;407
8;Barcelona;1;Barcelona;41;Vallès Oriental;08136;Montornès del Vallès;2;3;;820;250;364;442;378;1;4;437;441
25;Lleida;4;Lleida;32;Segarra;25143;Montornès de Segarra;1;1;;83;34;52;83;0;2;1;80;81
43;Tarragona;6;Camp de Tarragona;1;Alt Camp;43091;Mont-ral;1;1;;124;45;71;98;26;0;9;89;98
17;Girona;3;Girona;10;Baix Empordà;17110;Mont-ras;1;1;;1362;576;834;982;380;18;24;940;964
43;Tarragona;6;Camp de Tarragona;8;Baix Camp;43092;Mont-roig del Camp;1;1;;1154;523;707;868;286;8;12;848;860
43;Tarragona;6;Camp de Tarragona;8;Baix Camp;43092;Mont-roig del Camp;1;2;;695;230;340;413;282;1;2;410;412
43;Tarragona;6;Camp de Tarragona;8;Baix Camp;43092;Mont-roig del Camp;1;3;;943;438;599;745;198;7;2;736;738
43;Tarragona;6;Camp de Tarragona;8;Baix Camp;43092;Mont-roig del Camp;1;4;;691;208;275;360;331;0;5;355;360
43;Tarragona;6;Camp de Tarragona;8;Baix Camp;43092;Mont-roig del Camp;1;5;;1256;431;605;786;470;8;7;771;778
43;Tarragona;6;Camp de Tarragona;8;Baix Camp;43092;Mont-roig del Camp;1;6;;965;353;546;581;384;1;4;576;580
43;Tarragona;6;Camp de Tarragona;8;Baix Camp;43092;Mont-roig del Camp;1;7;;1019;302;427;555;464;4;1;550;551
43;Tarragona;6;Camp de Tarragona;8;Baix Camp;43092;Mont-roig del Camp;1;8;;1061;299;392;524;537;3;2;519;521
8;Barcelona;1;Barcelona;41;Vallès Oriental;08137;Montseny;1;1;;276;136;180;246;30;4;0;242;242
43;Tarragona;7;Terres de l'Ebre;30;Ribera d'Ebre;43093;Móra d'Ebre;1;1;;1185;490;665;847;338;11;12;824;836
43;Tarragona;7;Terres de l'Ebre;30;Ribera d'Ebre;43093;Móra d'Ebre;1;2;;1711;662;916;1207;504;7;27;1173;1200
43;Tarragona;7;Terres de l'Ebre;30;Ribera d'Ebre;43093;Móra d'Ebre;2;1;;1021;440;585;728;293;8;9;711;720
43;Tarragona;7;Terres de l'Ebre;30;Ribera d'Ebre;43094;Móra la Nova;1;1;;1301;570;777;957;344;22;19;916;935
43;Tarragona;7;Terres de l'Ebre;30;Ribera d'Ebre;43094;Móra la Nova;2;1;;857;392;517;658;199;10;14;634;648
43;Tarragona;6;Camp de Tarragona;36;Tarragonès;43095;Morell, el;1;1;;1429;571;835;996;433;16;11;969;980
43;Tarragona;6;Camp de Tarragona;36;Tarragonès;43095;Morell, el;1;2;;1156;468;648;830;326;3;8;819;827
43;Tarragona;6;Camp de Tarragona;29;Priorat;43096;Morera de Montsant, la;1;1;;109;52;71;90;19;1;0;89;89
8;Barcelona;2;Catalunya Central;24;Osona;08129;Muntanyola;1;1;;491;230;318;387;104;3;15;369;384
8;Barcelona;2;Catalunya Central;7;Bages;08139;Mura;1;1;;177;94;127;167;10;0;0;167;167
25;Lleida;4;Lleida;38;Urgell;25145;Nalec;1;1;;76;32;53;68;8;1;2;65;67
25;Lleida;5;Alt Pirineu i territori d'Aran;39;Consell General d'Aran;25025;Naut Aran;1;1;;1389;495;700;1047;342;8;21;1018;1039
8;Barcelona;2;Catalunya Central;7;Bages;08140;Navarcles;1;1;;1451;492;766;958;493;16;15;927;942
8;Barcelona;2;Catalunya Central;7;Bages;08140;Navarcles;1;2;;1643;595;861;1126;517;4;15;1107;1122
8;Barcelona;2;Catalunya Central;7;Bages;08140;Navarcles;1;3;;1704;603;940;1165;539;7;11;1147;1158
8;Barcelona;2;Catalunya Central;7;Bages;08141;Navàs;1;1;;900;415;573;695;205;8;24;663;687
8;Barcelona;2;Catalunya Central;7;Bages;08141;Navàs;1;2;;552;235;335;418;134;5;11;402;413
8;Barcelona;2;Catalunya Central;7;Bages;08141;Navàs;1;3;;1776;625;890;1167;609;11;27;1129;1156
8;Barcelona;2;Catalunya Central;7;Bages;08141;Navàs;1;4;;1164;487;683;893;271;14;21;858;879
8;Barcelona;2;Catalunya Central;7;Bages;08141;Navàs;2;1;;219;101;127;155;64;5;8;142;150
17;Girona;3;Girona;2;Alt Empordà;17111;Navata;1;1;;989;424;610;732;257;4;34;694;728
25;Lleida;2;Catalunya Central;35;Solsonès;25146;Navès;1;1;;223;79;119;162;61;7;21;134;155
8;Barcelona;2;Catalunya Central;14;Berguedà;08142;Nou de Berguedà, la;1;1;;141;81;107;123;18;6;35;82;117
43;Tarragona;6;Camp de Tarragona;36;Tarragonès;43097;Nou de Gaià, la;1;1;;412;213;287;341;71;8;11;322;333
43;Tarragona;6;Camp de Tarragona;1;Alt Camp;43098;Nulles;1;1;;358;124;184;257;101;14;27;216;243
25;Lleida;2;Catalunya Central;35;Solsonès;25148;Odèn;1;1;;236;111;138;208;28;2;2;204;206
8;Barcelona;8;Penedès;6;Anoia;08143;Òdena;1;1;;1754;662;977;1300;454;5;18;1277;1295
8;Barcelona;8;Penedès;6;Anoia;08143;Òdena;1;2;;980;349;485;634;346;9;12;613;625
17;Girona;3;Girona;31;Ripollès;17112;Ogassa;1;1;;195;97;136;165;30;0;5;160;165
8;Barcelona;8;Penedès;3;Alt Penedès;08145;Olèrdola;1;1;;1625;566;865;1051;574;13;14;1024;1038
8;Barcelona;8;Penedès;3;Alt Penedès;08145;Olèrdola;1;2;;1091;530;728;871;220;2;18;851;869
8;Barcelona;8;Penedès;3;Alt Penedès;08146;Olesa de Bonesvalls;1;1;;627;270;359;464;163;3;8;453;461
8;Barcelona;8;Penedès;3;Alt Penedès;08146;Olesa de Bonesvalls;1;2;;751;245;361;456;295;2;6;448;454
8;Barcelona;1;Barcelona;11;Baix Llobregat;08147;Olesa de Montserrat;1;1;;1495;421;602;781;714;3;6;772;778
8;Barcelona;1;Barcelona;11;Baix Llobregat;08147;Olesa de Montserrat;1;10;;1392;436;560;809;583;4;0;805;805
8;Barcelona;1;Barcelona;11;Baix Llobregat;08147;Olesa de Montserrat;1;11;;1722;506;725;1019;703;1;14;1004;1018
8;Barcelona;1;Barcelona;11;Baix Llobregat;08147;Olesa de Montserrat;1;12;;1218;368;556;740;478;2;6;732;738
8;Barcelona;1;Barcelona;11;Baix Llobregat;08147;Olesa de Montserrat;1;2;;1571;577;783;962;609;7;5;950;955
8;Barcelona;1;Barcelona;11;Baix Llobregat;08147;Olesa de Montserrat;1;3;;969;387;525;655;314;0;5;650;655
8;Barcelona;1;Barcelona;11;Baix Llobregat;08147;Olesa de Montserrat;1;4;;1618;561;765;1080;538;6;8;1066;1074
8;Barcelona;1;Barcelona;11;Baix Llobregat;08147;Olesa de Montserrat;1;5;;1564;519;739;972;592;4;10;958;968
8;Barcelona;1;Barcelona;11;Baix Llobregat;08147;Olesa de Montserrat;1;6;;1372;458;618;833;539;5;6;822;828
8;Barcelona;1;Barcelona;11;Baix Llobregat;08147;Olesa de Montserrat;1;7;;1361;489;627;791;570;10;8;773;781
8;Barcelona;1;Barcelona;11;Baix Llobregat;08147;Olesa de Montserrat;1;8;;1678;627;834;1073;605;10;12;1051;1063
8;Barcelona;1;Barcelona;11;Baix Llobregat;08147;Olesa de Montserrat;1;9;;1399;489;711;940;459;7;2;931;933
25;Lleida;5;Alt Pirineu i territori d'Aran;4;Alt Urgell;25149;Oliana;1;1;;1380;596;916;1107;273;19;20;1068;1088
25;Lleida;4;Lleida;23;Noguera;25150;Oliola;1;1;;170;97;115;139;31;3;1;135;136
25;Lleida;2;Catalunya Central;35;Solsonès;25151;Olius;1;1;;738;338;470;555;183;4;21;530;551
8;Barcelona;8;Penedès;17;Garraf;08148;Olivella;1;1;;1112;369;547;694;418;5;10;679;689
8;Barcelona;8;Penedès;17;Garraf;08148;Olivella;1;2;;1322;425;640;819;503;1;2;816;818
8;Barcelona;2;Catalunya Central;24;Osona;08149;Olost;1;1;;986;273;516;675;311;61;79;535;614
17;Girona;3;Girona;19;Garrotxa;17114;Olot;1;1;;1156;347;467;591;565;1;3;587;590
17;Girona;3;Girona;19;Garrotxa;17114;Olot;1;2;;785;288;375;456;329;1;5;450;455
17;Girona;3;Girona;19;Garrotxa;17114;Olot;1;3;;833;320;497;615;218;7;1;607;608
17;Girona;3;Girona;19;Garrotxa;17114;Olot;1;4;;626;271;379;463;163;4;13;446;459
17;Girona;3;Girona;19;Garrotxa;17114;Olot;1;5;;604;261;354;435;169;0;6;429;435
17;Girona;3;Girona;19;Garrotxa;17114;Olot;1;6;;557;240;313;375;182;4;1;370;371
17;Girona;3;Girona;19;Garrotxa;17114;Olot;1;7;;1148;500;623;745;403;1;5;739;744
17;Girona;3;Girona;19;Garrotxa;17114;Olot;2;1;;1711;676;981;1211;500;8;10;1193;1203
17;Girona;3;Girona;19;Garrotxa;17114;Olot;2;2;;1580;580;845;1058;522;7;5;1046;1051
17;Girona;3;Girona;19;Garrotxa;17114;Olot;2;3;;1192;398;463;672;520;1;2;669;671
17;Girona;3;Girona;19;Garrotxa;17114;Olot;2;4;;1013;319;484;593;420;1;5;587;592
17;Girona;3;Girona;19;Garrotxa;17114;Olot;2;5;;966;339;485;610;356;3;4;603;607
17;Girona;3;Girona;19;Garrotxa;17114;Olot;3;1;;591;208;309;380;211;0;2;378;380
17;Girona;3;Girona;19;Garrotxa;17114;Olot;3;2;;1363;520;818;991;372;6;9;976;985
17;Girona;3;Girona;19;Garrotxa;17114;Olot;3;3;;1673;702;903;1125;548;8;7;1110;1117
17;Girona;3;Girona;19;Garrotxa;17114;Olot;4;1;;1116;345;513;657;459;1;8;648;656
17;Girona;3;Girona;19;Garrotxa;17114;Olot;4;2;;1746;533;791;956;790;9;12;935;947
17;Girona;3;Girona;19;Garrotxa;17114;Olot;5;1;;1058;382;584;719;339;2;4;713;717
17;Girona;3;Girona;19;Garrotxa;17114;Olot;5;2;;1050;448;653;788;262;6;4;778;782
17;Girona;3;Girona;19;Garrotxa;17114;Olot;5;3;;1685;645;896;1121;564;3;10;1108;1118
17;Girona;3;Girona;19;Garrotxa;17114;Olot;5;4;;1295;523;773;1008;287;2;14;992;1006
25;Lleida;4;Lleida;32;Segarra;25152;Oluges, les;1;1;;144;60;89;112;32;2;1;109;110
8;Barcelona;2;Catalunya Central;14;Berguedà;08144;Olvan;1;1;;719;309;467;573;146;18;11;544;555
25;Lleida;4;Lleida;18;Garrigues;25153;Omellons, els;1;1;;192;87;124;153;39;2;3;148;151
25;Lleida;4;Lleida;38;Urgell;25154;Omells de na Gaia, els;1;1;;118;53;73;93;25;7;8;78;86
17;Girona;3;Girona;2;Alt Empordà;17115;Ordis;1;1;;288;97;162;208;80;16;24;168;192
25;Lleida;5;Alt Pirineu i territori d'Aran;4;Alt Urgell;25155;Organyà;1;1;;634;328;445;518;116;6;8;504;512
8;Barcelona;2;Catalunya Central;24;Osona;08150;Orís;1;1;;257;102;176;229;28;0;2;227;229
8;Barcelona;2;Catalunya Central;24;Osona;08151;Oristà;1;1;;452;159;293;352;100;23;45;284;329
8;Barcelona;8;Penedès;6;Anoia;08152;Orpí;1;1;;120;57;71;103;17;0;0;103;103
8;Barcelona;1;Barcelona;21;Maresme;08153;Òrrius;1;1;;567;275;348;430;137;8;13;409;422
25;Lleida;4;Lleida;23;Noguera;25156;Os de Balaguer;1;1;;789;279;405;537;252;30;78;429;507
17;Girona;3;Girona;34;Selva;17116;Osor;1;1;;362;144;209;252;110;9;20;223;243
25;Lleida;4;Lleida;38;Urgell;25157;Ossó de Sió;1;1;;165;69;104;141;24;1;3;137;140
8;Barcelona;8;Penedès;3;Alt Penedès;08154;Pacs del Penedès;1;1;;713;314;443;539;174;12;32;495;527
8;Barcelona;1;Barcelona;21;Maresme;08155;Palafolls;1;1;;2052;771;1148;1418;634;8;11;1399;1410
8;Barcelona;1;Barcelona;21;Maresme;08155;Palafolls;1;2;;1104;426;612;760;344;1;6;753;759
8;Barcelona;1;Barcelona;21;Maresme;08155;Palafolls;1;3;;1621;485;741;910;711;4;7;899;906
8;Barcelona;1;Barcelona;21;Maresme;08155;Palafolls;1;4;;1304;456;671;851;453;8;1;842;843
8;Barcelona;1;Barcelona;21;Maresme;08155;Palafolls;1;5;;948;268;428;552;396;4;9;539;548
17;Girona;3;Girona;10;Baix Empordà;17117;Palafrugell;1;1;;1565;541;772;936;629;18;11;907;918
17;Girona;3;Girona;10;Baix Empordà;17117;Palafrugell;1;2;;1553;472;719;935;618;2;8;925;933
17;Girona;3;Girona;10;Baix Empordà;17117;Palafrugell;1;3;;1166;310;514;656;510;3;8;645;653
17;Girona;3;Girona;10;Baix Empordà;17117;Palafrugell;1;4;;1385;468;681;827;558;12;9;806;815
17;Girona;3;Girona;10;Baix Empordà;17117;Palafrugell;1;5;;984;299;443;543;441;1;5;537;542
17;Girona;3;Girona;10;Baix Empordà;17117;Palafrugell;2;1;;1608;553;759;980;628;9;8;963;971
17;Girona;3;Girona;10;Baix Empordà;17117;Palafrugell;2;2;;1578;500;731;892;686;5;8;879;887
17;Girona;3;Girona;10;Baix Empordà;17117;Palafrugell;2;3;;1637;508;761;958;679;12;12;934;946
17;Girona;3;Girona;10;Baix Empordà;17117;Palafrugell;3;1;;1005;330;475;609;396;5;6;598;604
17;Girona;3;Girona;10;Baix Empordà;17117;Palafrugell;3;2;;1537;561;805;1001;536;6;7;988;995
17;Girona;3;Girona;10;Baix Empordà;17117;Palafrugell;3;3;;955;253;405;514;441;0;12;502;514
17;Girona;3;Girona;10;Baix Empordà;17118;Palamós;1;1;;1343;589;775;885;458;12;7;866;873
17;Girona;3;Girona;10;Baix Empordà;17118;Palamós;1;2;;1428;456;692;874;554;3;14;857;871
17;Girona;3;Girona;10;Baix Empordà;17118;Palamós;1;3;;1098;377;542;680;418;12;9;659;668
17;Girona;3;Girona;10;Baix Empordà;17118;Palamós;1;4;;667;232;326;428;239;1;2;425;427
17;Girona;3;Girona;10;Baix Empordà;17118;Palamós;2;1;;1002;340;491;623;379;10;5;608;613
17;Girona;3;Girona;10;Baix Empordà;17118;Palamós;2;2;;1263;469;627;774;489;4;6;764;770
17;Girona;3;Girona;10;Baix Empordà;17118;Palamós;3;1;;1279;419;607;753;526;4;12;737;749
17;Girona;3;Girona;10;Baix Empordà;17118;Palamós;3;2;;1233;395;564;712;521;3;10;699;709
17;Girona;3;Girona;10;Baix Empordà;17118;Palamós;3;3;;1513;544;757;936;577;7;13;916;929
17;Girona;3;Girona;10;Baix Empordà;17118;Palamós;4;1;;1415;420;634;791;624;6;5;780;785
17;Girona;3;Girona;10;Baix Empordà;17118;Palamós;4;2;;1004;301;482;617;387;11;4;602;606
25;Lleida;4;Lleida;27;Pla d'Urgell;25158;Palau d'Anglesola, el;1;1;;1618;689;959;1275;343;6;31;1238;1269
17;Girona;3;Girona;2;Alt Empordà;17119;Palau de Santa Eulàlia;1;1;;75;35;44;58;17;1;2;55;57
17;Girona;3;Girona;10;Baix Empordà;17121;Palau-sator;1;1;;233;98;149;165;68;6;19;140;159
17;Girona;3;Girona;2;Alt Empordà;17120;Palau-saverdera;1;1;;995;399;564;703;292;4;10;689;699
8;Barcelona;1;Barcelona;40;Vallès Occidental;08156;Palau-solità i Plegamans;1;1;;1134;387;482;665;469;1;5;659;664
8;Barcelona;1;Barcelona;40;Vallès Occidental;08156;Palau-solità i Plegamans;1;2;;1970;632;959;1255;715;7;12;1236;1248
8;Barcelona;1;Barcelona;40;Vallès Occidental;08156;Palau-solità i Plegamans;1;3;;1378;483;675;868;510;3;10;855;865
8;Barcelona;1;Barcelona;40;Vallès Occidental;08156;Palau-solità i Plegamans;1;4;;1930;687;987;1295;635;6;10;1279;1289
8;Barcelona;1;Barcelona;40;Vallès Occidental;08156;Palau-solità i Plegamans;1;5;;874;358;478;612;262;4;10;598;608
8;Barcelona;1;Barcelona;40;Vallès Occidental;08156;Palau-solità i Plegamans;1;6;;1517;552;796;1004;513;4;3;997;1000
8;Barcelona;1;Barcelona;40;Vallès Occidental;08156;Palau-solità i Plegamans;1;7;;1221;389;573;753;468;5;6;742;748
8;Barcelona;1;Barcelona;40;Vallès Occidental;08156;Palau-solità i Plegamans;1;8;;1209;421;603;755;454;7;5;743;748
43;Tarragona;6;Camp de Tarragona;36;Tarragonès;43100;Pallaresos, els;1;1;;1205;408;632;876;329;7;7;862;869
43;Tarragona;6;Camp de Tarragona;36;Tarragonès;43100;Pallaresos, els;1;2;;1283;421;608;841;442;2;8;831;839
43;Tarragona;6;Camp de Tarragona;36;Tarragonès;43100;Pallaresos, els;1;3;;1032;293;432;565;467;6;7;552;559
8;Barcelona;1;Barcelona;11;Baix Llobregat;08157;Pallejà;1;1;;1891;727;994;1302;589;1;7;1294;1301
8;Barcelona;1;Barcelona;11;Baix Llobregat;08157;Pallejà;1;2;;1799;648;909;1194;605;2;8;1184;1192
8;Barcelona;1;Barcelona;11;Baix Llobregat;08157;Pallejà;1;3;;1618;631;888;1137;481;8;11;1118;1129
8;Barcelona;1;Barcelona;11;Baix Llobregat;08157;Pallejà;1;4;;1404;469;708;961;443;2;4;955;959
8;Barcelona;1;Barcelona;11;Baix Llobregat;08157;Pallejà;1;5;;1910;748;1059;1385;525;3;4;1378;1382
43;Tarragona;7;Terres de l'Ebre;30;Ribera d'Ebre;43099;Palma d'Ebre, la;1;1;;291;173;216;249;42;1;5;243;248
8;Barcelona;1;Barcelona;11;Baix Llobregat;08905;Palma de Cervelló, la;1;1;;1199;592;696;890;309;10;14;866;880
8;Barcelona;1;Barcelona;11;Baix Llobregat;08905;Palma de Cervelló, la;1;2;;1126;451;655;810;316;3;18;789;807
17;Girona;3;Girona;28;Pla de l'Estany;17123;Palol de Revardit;1;1;;349;174;244;293;56;3;24;266;290
17;Girona;3;Girona;10;Baix Empordà;17124;Pals;1;1;;1794;657;989;1244;550;12;29;1203;1232
8;Barcelona;1;Barcelona;11;Baix Llobregat;08158;Papiol, el;1;1;;1765;594;899;1170;595;11;32;1127;1159
8;Barcelona;1;Barcelona;11;Baix Llobregat;08158;Papiol, el;1;2;;1371;428;648;899;472;13;22;864;886
17;Girona;3;Girona;31;Ripollès;17125;Pardines;1;1;;132;46;78;100;32;2;3;95;98
8;Barcelona;1;Barcelona;41;Vallès Oriental;08159;Parets del Vallès;1;1;;1236;440;646;816;420;2;7;807;814
8;Barcelona;1;Barcelona;41;Vallès Oriental;08159;Parets del Vallès;1;2;;1671;501;810;1085;586;2;7;1076;1083
8;Barcelona;1;Barcelona;41;Vallès Oriental;08159;Parets del Vallès;1;3;;1066;405;530;678;388;0;4;674;678
8;Barcelona;1;Barcelona;41;Vallès Oriental;08159;Parets del Vallès;1;4;;926;321;452;617;309;1;2;614;616
8;Barcelona;1;Barcelona;41;Vallès Oriental;08159;Parets del Vallès;2;1;;1021;332;512;617;404;2;7;608;615
8;Barcelona;1;Barcelona;41;Vallès Oriental;08159;Parets del Vallès;2;2;;933;298;455;588;345;1;5;582;587
8;Barcelona;1;Barcelona;41;Vallès Oriental;08159;Parets del Vallès;2;3;;1819;628;877;1087;732;3;5;1079;1084
8;Barcelona;1;Barcelona;41;Vallès Oriental;08159;Parets del Vallès;2;4;;1235;430;633;768;467;1;3;764;767
8;Barcelona;1;Barcelona;41;Vallès Oriental;08159;Parets del Vallès;2;5;;996;350;510;652;344;3;5;644;649
8;Barcelona;1;Barcelona;41;Vallès Oriental;08159;Parets del Vallès;2;6;;1888;600;889;1246;642;6;7;1233;1240
8;Barcelona;1;Barcelona;41;Vallès Oriental;08159;Parets del Vallès;2;7;;1609;545;808;1042;567;4;4;1034;1038
17;Girona;3;Girona;10;Baix Empordà;17126;Parlavà;1;1;;324;158;223;257;67;5;21;231;252
43;Tarragona;6;Camp de Tarragona;16;Conca de Barberà;43101;Passanant i Belltall;1;1;;153;76;114;136;17;0;1;135;136
17;Girona;3;Girona;2;Alt Empordà;17128;Pau;1;1;;369;199;250;319;50;0;2;317;319
43;Tarragona;7;Terres de l'Ebre;9;Baix Ebre;43102;Paüls;1;1;;471;203;315;407;64;27;10;370;380
17;Girona;3;Girona;2;Alt Empordà;17129;Pedret i Marzà;1;1;;146;74;99;125;21;1;2;122;124
25;Lleida;4;Lleida;23;Noguera;25164;Penelles;1;1;;356;146;208;270;86;5;7;258;265
17;Girona;3;Girona;10;Baix Empordà;17130;Pera, la;1;1;;340;133;199;251;89;11;21;219;240
8;Barcelona;2;Catalunya Central;24;Osona;08160;Perafita;1;1;;319;154;206;255;64;2;14;239;253
43;Tarragona;6;Camp de Tarragona;36;Tarragonès;43103;Perafort;1;1;;911;414;615;740;171;6;9;725;734
17;Girona;3;Girona;2;Alt Empordà;17132;Peralada;1;1;;1370;550;824;1018;352;23;84;911;995
25;Lleida;5;Alt Pirineu i territori d'Aran;4;Alt Urgell;25165;Peramola;1;1;;278;120;183;231;47;18;10;203;213
43;Tarragona;7;Terres de l'Ebre;9;Baix Ebre;43104;Perelló, el;1;1;;601;269;347;424;177;25;23;376;399
43;Tarragona;7;Terres de l'Ebre;9;Baix Ebre;43104;Perelló, el;1;2;;1295;596;817;998;297;36;32;930;962
8;Barcelona;8;Penedès;6;Anoia;08161;Piera;1;1;;888;290;416;520;368;3;2;515;517
8;Barcelona;8;Penedès;6;Anoia;08161;Piera;1;2;;2319;723;1053;1333;986;14;16;1303;1319
8;Barcelona;8;Penedès;6;Anoia;08161;Piera;1;3;;1773;582;863;1110;663;8;14;1088;1102
8;Barcelona;8;Penedès;6;Anoia;08161;Piera;1;4;;1423;438;621;765;658;8;1;756;757
8;Barcelona;8;Penedès;6;Anoia;08161;Piera;1;5;;1474;522;713;867;607;4;8;855;863
8;Barcelona;8;Penedès;6;Anoia;08161;Piera;1;6;;1079;343;474;574;505;5;5;564;569
8;Barcelona;8;Penedès;6;Anoia;08161;Piera;1;7;;695;220;305;393;302;5;1;387;388
8;Barcelona;8;Penedès;6;Anoia;08161;Piera;1;8;;1231;384;521;650;581;2;6;642;648
8;Barcelona;8;Penedès;6;Anoia;08161;Piera;1;9;;828;289;373;451;377;3;0;448;448
43;Tarragona;6;Camp de Tarragona;16;Conca de Barberà;43105;Piles, les;1;1;;154;65;91;116;38;5;9;102;111
8;Barcelona;1;Barcelona;21;Maresme;08163;Pineda de Mar;1;1;;1648;643;872;1040;608;1;5;1034;1039
8;Barcelona;1;Barcelona;21;Maresme;08163;Pineda de Mar;1;10;;1164;418;569;705;459;9;6;690;696
8;Barcelona;1;Barcelona;21;Maresme;08163;Pineda de Mar;1;11;;1164;475;622;763;401;5;5;753;758
8;Barcelona;1;Barcelona;21;Maresme;08163;Pineda de Mar;1;12;;1122;426;571;691;431;4;4;683;687
8;Barcelona;1;Barcelona;21;Maresme;08163;Pineda de Mar;1;13;;1402;561;753;920;482;2;7;911;918
8;Barcelona;1;Barcelona;21;Maresme;08163;Pineda de Mar;1;14;;1400;515;715;856;544;6;5;845;850
8;Barcelona;1;Barcelona;21;Maresme;08163;Pineda de Mar;1;2;;1715;622;863;1059;656;3;11;1045;1056
8;Barcelona;1;Barcelona;21;Maresme;08163;Pineda de Mar;1;3;;1335;473;661;833;502;1;5;827;832
8;Barcelona;1;Barcelona;21;Maresme;08163;Pineda de Mar;1;4;;2130;742;1075;1298;832;4;3;1291;1294
8;Barcelona;1;Barcelona;21;Maresme;08163;Pineda de Mar;1;5;;1147;395;556;686;461;4;7;675;682
8;Barcelona;1;Barcelona;21;Maresme;08163;Pineda de Mar;1;6;;1173;442;563;688;485;1;2;685;687
8;Barcelona;1;Barcelona;21;Maresme;08163;Pineda de Mar;1;7;;1692;615;837;1080;612;11;8;1061;1069
8;Barcelona;1;Barcelona;21;Maresme;08163;Pineda de Mar;1;8;;1099;404;562;675;424;2;2;671;673
8;Barcelona;1;Barcelona;21;Maresme;08163;Pineda de Mar;1;9;;1514;549;749;946;568;1;9;936;945
43;Tarragona;7;Terres de l'Ebre;37;Terra Alta;43106;Pinell de Brai, el;1;1;;813;387;574;727;86;12;11;704;715
25;Lleida;2;Catalunya Central;35;Solsonès;25166;Pinell de Solsonès;1;1;;173;78;109;147;26;2;3;142;145
25;Lleida;2;Catalunya Central;35;Solsonès;25167;Pinós;1;1;;226;111;151;187;39;4;9;174;183
43;Tarragona;6;Camp de Tarragona;16;Conca de Barberà;43107;Pira;1;1;;386;145;213;262;124;16;24;222;246
8;Barcelona;8;Penedès;3;Alt Penedès;08164;Pla del Penedès, el;1;1;;940;410;591;721;219;15;24;682;706
43;Tarragona;6;Camp de Tarragona;1;Alt Camp;43108;Pla de Santa Maria, el;1;1;;1786;756;1037;1329;457;23;28;1278;1306
17;Girona;3;Girona;19;Garrotxa;17133;Planes d'Hostoles, les;1;1;;1286;601;828;934;352;87;145;702;847
17;Girona;3;Girona;31;Ripollès;17134;Planoles;1;1;;222;104;155;199;23;1;8;190;198
25;Lleida;4;Lleida;32;Segarra;25911;Plans de Sió, els;1;1;;425;164;255;314;111;10;12;292;304
25;Lleida;4;Lleida;27;Pla d'Urgell;25168;Poal, el;1;1;;491;270;356;416;75;4;28;384;412
25;Lleida;4;Lleida;18;Garrigues;25169;Pobla de Cérvoles, la;1;1;;166;65;115;141;25;2;3;136;139
8;Barcelona;8;Penedès;6;Anoia;08165;Pobla de Claramunt, la;1;1;;1677;639;916;1197;480;11;12;1174;1186
8;Barcelona;2;Catalunya Central;14;Berguedà;08166;Pobla de Lillet, la;1;1;;967;429;686;763;204;13;24;726;750
43;Tarragona;6;Camp de Tarragona;36;Tarragonès;43109;Pobla de Mafumet, la;1;1;;2020;834;1106;1380;640;9;15;1356;1371
43;Tarragona;6;Camp de Tarragona;36;Tarragonès;43109;Pobla de Mafumet, la;1;2;;730;275;387;511;219;2;3;506;509
43;Tarragona;7;Terres de l'Ebre;37;Terra Alta;43110;Pobla de Massaluca, la;1;1;;255;89;146;186;69;2;28;156;184
43;Tarragona;6;Camp de Tarragona;36;Tarragonès;43111;Pobla de Montornès, la;1;1;;774;322;444;538;236;8;5;525;530
43;Tarragona;6;Camp de Tarragona;36;Tarragonès;43111;Pobla de Montornès, la;1;2;;1351;445;609;773;578;7;7;759;766
25;Lleida;5;Alt Pirineu i territori d'Aran;25;Pallars Jussà;25171;Pobla de Segur, la;1;1;;992;396;516;722;270;6;15;701;716
25;Lleida;5;Alt Pirineu i territori d'Aran;25;Pallars Jussà;25171;Pobla de Segur, la;1;2;;1160;494;645;843;317;4;23;816;839
43;Tarragona;6;Camp de Tarragona;29;Priorat;43112;Poboleda;1;1;;251;126;180;213;38;2;5;206;211
8;Barcelona;1;Barcelona;40;Vallès Occidental;08167;Polinyà;1;1;;1302;515;688;860;442;3;3;854;857
8;Barcelona;1;Barcelona;40;Vallès Occidental;08167;Polinyà;1;2;;1161;380;511;659;502;4;6;649;655
8;Barcelona;1;Barcelona;40;Vallès Occidental;08167;Polinyà;1;3;;1404;473;693;897;507;1;8;888;896
8;Barcelona;1;Barcelona;40;Vallès Occidental;08167;Polinyà;1;4;;1416;492;747;987;429;3;2;982;984
8;Barcelona;1;Barcelona;40;Vallès Occidental;08167;Polinyà;1;5;;796;277;394;501;295;0;3;498;501
43;Tarragona;6;Camp de Tarragona;1;Alt Camp;43113;Pont d'Armentera, el;1;1;;399;215;268;311;88;12;11;288;299
25;Lleida;5;Alt Pirineu i territori d'Aran;4;Alt Urgell;25030;Pont de Bar, el;1;1;;124;61;74;98;26;1;1;96;97
17;Girona;3;Girona;2;Alt Empordà;17135;Pont de Molins;1;1;;417;216;318;352;65;0;2;350;352
25;Lleida;5;Alt Pirineu i territori d'Aran;5;Alta Ribagorça;25173;Pont de Suert, el;1;1;;1150;403;595;842;308;17;32;793;825
25;Lleida;5;Alt Pirineu i territori d'Aran;5;Alta Ribagorça;25173;Pont de Suert, el;1;2;;509;215;275;340;169;2;9;329;338
8;Barcelona;2;Catalunya Central;7;Bages;08182;Pont de Vilomara i Rocafort, el;1;1;;2971;1228;1691;2090;881;13;18;2059;2077
43;Tarragona;6;Camp de Tarragona;16;Conca de Barberà;43141;Pontils;1;1;;105;60;67;89;16;1;3;85;88
8;Barcelona;8;Penedès;3;Alt Penedès;08168;Pontons;1;1;;392;184;251;311;81;3;0;308;308
17;Girona;3;Girona;2;Alt Empordà;17136;Pontós;1;1;;205;113;150;181;24;4;2;175;177
25;Lleida;4;Lleida;23;Noguera;25172;Ponts;1;1;;722;342;445;545;177;12;22;511;533
25;Lleida;4;Lleida;23;Noguera;25172;Ponts;1;2;;1075;503;698;868;207;23;41;804;845
17;Girona;3;Girona;28;Pla de l'Estany;17137;Porqueres;1;1;;576;217;333;416;160;8;19;389;408
17;Girona;3;Girona;28;Pla de l'Estany;17137;Porqueres;1;2;;1657;732;993;1243;414;23;41;1179;1220
17;Girona;3;Girona;28;Pla de l'Estany;17137;Porqueres;1;3;;1261;531;792;997;264;11;31;955;986
43;Tarragona;6;Camp de Tarragona;29;Priorat;43114;Porrera;1;1;;378;174;237;296;82;17;22;257;279
17;Girona;3;Girona;2;Alt Empordà;17138;Portbou;1;1;;865;405;550;642;223;53;56;533;589
17;Girona;3;Girona;2;Alt Empordà;17140;Port de la Selva, el;1;1;;693;397;493;563;130;21;15;527;542
25;Lleida;4;Lleida;33;Segrià;25174;Portella, la;1;1;;431;198;301;381;50;2;3;376;379
43;Tarragona;6;Camp de Tarragona;29;Priorat;43115;Pradell de la Teixeta;1;1;;128;55;80;105;23;4;16;85;101
43;Tarragona;6;Camp de Tarragona;8;Baix Camp;43116;Prades;1;1;;471;241;304;371;100;16;15;340;355
43;Tarragona;7;Terres de l'Ebre;37;Terra Alta;43117;Prat de Comte;1;1;;143;68;96;116;27;8;5;103;108
8;Barcelona;1;Barcelona;11;Baix Llobregat;08169;Prat de Llobregat, el;1;1;;1431;545;771;974;457;3;11;960;971
8;Barcelona;1;Barcelona;11;Baix Llobregat;08169;Prat de Llobregat, el;1;2;;1496;575;804;998;498;2;6;990;996
8;Barcelona;1;Barcelona;11;Baix Llobregat;08169;Prat de Llobregat, el;1;3;;1018;379;553;714;304;3;6;705;711
8;Barcelona;1;Barcelona;11;Baix Llobregat;08169;Prat de Llobregat, el;1;4;;1349;503;685;853;496;2;1;850;851
8;Barcelona;1;Barcelona;11;Baix Llobregat;08169;Prat de Llobregat, el;1;5;;1180;409;538;676;504;1;3;672;675
8;Barcelona;1;Barcelona;11;Baix Llobregat;08169;Prat de Llobregat, el;2;1;;1284;499;661;822;462;3;7;812;819
8;Barcelona;1;Barcelona;11;Baix Llobregat;08169;Prat de Llobregat, el;2;2;;1571;610;863;1075;496;2;5;1068;1073
8;Barcelona;1;Barcelona;11;Baix Llobregat;08169;Prat de Llobregat, el;2;3;;1064;346;474;592;472;1;1;590;591
8;Barcelona;1;Barcelona;11;Baix Llobregat;08169;Prat de Llobregat, el;2;4;;1411;462;674;875;536;2;4;869;873
8;Barcelona;1;Barcelona;11;Baix Llobregat;08169;Prat de Llobregat, el;2;5;;1428;503;709;854;574;3;8;843;851
8;Barcelona;1;Barcelona;11;Baix Llobregat;08169;Prat de Llobregat, el;2;6;;1729;669;992;1208;521;1;9;1198;1207
8;Barcelona;1;Barcelona;11;Baix Llobregat;08169;Prat de Llobregat, el;2;7;;1473;542;767;975;498;2;3;970;973
8;Barcelona;1;Barcelona;11;Baix Llobregat;08169;Prat de Llobregat, el;3;1;;1125;433;630;799;326;3;7;789;796
8;Barcelona;1;Barcelona;11;Baix Llobregat;08169;Prat de Llobregat, el;3;10;;1418;452;636;808;610;1;4;803;807
8;Barcelona;1;Barcelona;11;Baix Llobregat;08169;Prat de Llobregat, el;3;11;;905;295;450;579;326;1;4;574;578
8;Barcelona;1;Barcelona;11;Baix Llobregat;08169;Prat de Llobregat, el;3;12;;538;173;276;371;167;0;1;370;371
8;Barcelona;1;Barcelona;11;Baix Llobregat;08169;Prat de Llobregat, el;3;13;;611;196;290;386;225;0;5;381;386
8;Barcelona;1;Barcelona;11;Baix Llobregat;08169;Prat de Llobregat, el;3;2;;791;294;398;497;294;2;3;492;495
8;Barcelona;1;Barcelona;11;Baix Llobregat;08169;Prat de Llobregat, el;3;3;;1269;425;595;756;513;0;0;756;756
8;Barcelona;1;Barcelona;11;Baix Llobregat;08169;Prat de Llobregat, el;3;4;;1141;373;481;609;532;1;4;604;608
8;Barcelona;1;Barcelona;11;Baix Llobregat;08169;Prat de Llobregat, el;3;5;;1578;565;759;1004;574;1;6;997;1003
8;Barcelona;1;Barcelona;11;Baix Llobregat;08169;Prat de Llobregat, el;3;6;;1058;373;492;653;405;2;3;648;651
8;Barcelona;1;Barcelona;11;Baix Llobregat;08169;Prat de Llobregat, el;3;7;;1511;575;791;992;519;0;2;990;992
8;Barcelona;1;Barcelona;11;Baix Llobregat;08169;Prat de Llobregat, el;3;8;;1667;549;771;963;704;2;3;958;961
8;Barcelona;1;Barcelona;11;Baix Llobregat;08169;Prat de Llobregat, el;3;9;;1687;553;771;982;705;4;3;975;978
8;Barcelona;1;Barcelona;11;Baix Llobregat;08169;Prat de Llobregat, el;4;1;;736;241;340;411;325;1;2;408;410
8;Barcelona;1;Barcelona;11;Baix Llobregat;08169;Prat de Llobregat, el;4;2;;1516;433;609;717;799;2;5;710;715
8;Barcelona;1;Barcelona;11;Baix Llobregat;08169;Prat de Llobregat, el;4;3;;1060;334;431;523;537;0;2;521;523
8;Barcelona;1;Barcelona;11;Baix Llobregat;08169;Prat de Llobregat, el;4;4;;973;236;319;392;581;1;0;391;391
8;Barcelona;1;Barcelona;11;Baix Llobregat;08169;Prat de Llobregat, el;4;5;;957;254;350;433;524;3;2;428;430
8;Barcelona;1;Barcelona;11;Baix Llobregat;08169;Prat de Llobregat, el;4;6;;728;81;116;142;586;2;0;140;140
8;Barcelona;1;Barcelona;11;Baix Llobregat;08169;Prat de Llobregat, el;5;1;;969;355;489;608;361;0;7;601;608
8;Barcelona;1;Barcelona;11;Baix Llobregat;08169;Prat de Llobregat, el;5;2;;996;331;460;627;369;3;4;620;624
8;Barcelona;1;Barcelona;11;Baix Llobregat;08169;Prat de Llobregat, el;5;3;;917;310;402;515;402;3;3;509;512
8;Barcelona;1;Barcelona;11;Baix Llobregat;08169;Prat de Llobregat, el;5;4;;1372;491;707;937;435;5;2;930;932
8;Barcelona;1;Barcelona;11;Baix Llobregat;08169;Prat de Llobregat, el;5;5;;1367;499;682;858;509;6;2;850;852
8;Barcelona;1;Barcelona;11;Baix Llobregat;08169;Prat de Llobregat, el;5;6;;1513;543;753;936;577;3;2;931;933
8;Barcelona;1;Barcelona;11;Baix Llobregat;08169;Prat de Llobregat, el;5;7;;1534;548;755;940;594;6;2;932;934
8;Barcelona;1;Barcelona;11;Baix Llobregat;08169;Prat de Llobregat, el;5;8;;1659;578;762;1067;592;4;3;1060;1063
8;Barcelona;1;Barcelona;11;Baix Llobregat;08169;Prat de Llobregat, el;5;9;;927;338;482;651;276;1;2;648;650
43;Tarragona;6;Camp de Tarragona;8;Baix Camp;43118;Pratdip;1;1;;572;342;433;487;85;6;17;464;481
8;Barcelona;2;Catalunya Central;24;Osona;08171;Prats de Lluçanès;1;1;;989;446;620;779;210;9;11;759;770
8;Barcelona;2;Catalunya Central;24;Osona;08171;Prats de Lluçanès;1;2;;1080;513;744;872;208;9;13;850;863
8;Barcelona;2;Catalunya Central;6;Anoia;08170;Prats de Rei, els;1;1;;442;155;244;303;139;13;24;266;290
25;Lleida;5;Alt Pirineu i territori d'Aran;15;Cerdanya;25175;Prats i Sansor;1;1;;178;66;92;133;45;2;6;125;131
25;Lleida;4;Lleida;38;Urgell;25176;Preixana;1;1;;312;143;187;235;77;24;20;191;211
25;Lleida;4;Lleida;23;Noguera;25177;Preixens;1;1;;361;142;204;269;92;4;8;257;265
8;Barcelona;1;Barcelona;21;Maresme;08230;Premià de Dalt;1;1;;1879;674;1051;1371;508;3;17;1351;1368
8;Barcelona;1;Barcelona;21;Maresme;08230;Premià de Dalt;1;2;;1513;538;776;990;523;6;10;974;984
8;Barcelona;1;Barcelona;21;Maresme;08230;Premià de Dalt;1;3;;1060;352;489;590;470;5;10;575;585
8;Barcelona;1;Barcelona;21;Maresme;08230;Premià de Dalt;1;4;;1355;504;717;906;449;1;3;902;905
8;Barcelona;1;Barcelona;21;Maresme;08230;Premià de Dalt;1;5;;689;228;330;414;275;1;5;408;413
8;Barcelona;1;Barcelona;21;Maresme;08230;Premià de Dalt;1;6;;1228;440;649;838;390;4;8;826;834
8;Barcelona;1;Barcelona;21;Maresme;08172;Premià de Mar;1;1;;1835;681;937;1272;563;2;2;1268;1270
8;Barcelona;1;Barcelona;21;Maresme;08172;Premià de Mar;1;2;;1642;701;960;1182;460;4;7;1171;1178
8;Barcelona;1;Barcelona;21;Maresme;08172;Premià de Mar;1;3;;1935;701;1047;1287;648;3;2;1282;1284
8;Barcelona;1;Barcelona;21;Maresme;08172;Premià de Mar;2;1;;1511;571;839;1055;456;2;6;1047;1053
8;Barcelona;1;Barcelona;21;Maresme;08172;Premià de Mar;2;2;;1527;505;781;912;615;3;7;902;909
8;Barcelona;1;Barcelona;21;Maresme;08172;Premià de Mar;2;3;;1252;388;634;785;467;2;6;777;783
8;Barcelona;1;Barcelona;21;Maresme;08172;Premià de Mar;2;4;;1174;317;489;612;562;0;5;607;612
8;Barcelona;1;Barcelona;21;Maresme;08172;Premià de Mar;3;1;;1203;405;605;760;443;1;4;755;759
8;Barcelona;1;Barcelona;21;Maresme;08172;Premià de Mar;3;2;;1062;352;487;615;447;1;5;609;614
8;Barcelona;1;Barcelona;21;Maresme;08172;Premià de Mar;3;3;;932;371;469;583;349;2;4;577;581
8;Barcelona;1;Barcelona;21;Maresme;08172;Premià de Mar;3;4;;1327;517;748;879;448;0;2;877;879
8;Barcelona;1;Barcelona;21;Maresme;08172;Premià de Mar;3;5;;979;266;407;500;479;0;6;494;500
8;Barcelona;1;Barcelona;21;Maresme;08172;Premià de Mar;3;6;;1170;372;556;724;446;1;3;720;723
8;Barcelona;1;Barcelona;21;Maresme;08172;Premià de Mar;3;7;;1069;318;552;701;368;2;5;694;699
8;Barcelona;1;Barcelona;21;Maresme;08172;Premià de Mar;3;8;;887;309;470;590;297;1;2;587;589
8;Barcelona;1;Barcelona;21;Maresme;08172;Premià de Mar;3;9;;1102;407;548;707;395;3;6;698;704
17;Girona;3;Girona;19;Garrotxa;17139;Preses, les;1;1;;1391;581;885;1063;328;20;26;1017;1043
25;Lleida;5;Alt Pirineu i territori d'Aran;15;Cerdanya;25179;Prullans;1;1;;173;78;101;140;33;4;2;134;136
17;Girona;5;Alt Pirineu i territori d'Aran;15;Cerdanya;17141;Puigcerdà;1;1;;630;151;243;316;314;6;2;308;310
17;Girona;5;Alt Pirineu i territori d'Aran;15;Cerdanya;17141;Puigcerdà;1;2;;1392;486;695;893;499;8;25;860;885
17;Girona;5;Alt Pirineu i territori d'Aran;15;Cerdanya;17141;Puigcerdà;1;3;;1470;484;697;926;544;9;15;902;917
17;Girona;5;Alt Pirineu i territori d'Aran;15;Cerdanya;17141;Puigcerdà;1;4;;1761;503;788;997;764;8;26;963;989
17;Girona;5;Alt Pirineu i territori d'Aran;15;Cerdanya;17141;Puigcerdà;1;5;;861;266;432;566;295;4;14;548;562
8;Barcelona;8;Penedès;3;Alt Penedès;08174;Puigdàlber;1;1;;394;192;263;322;72;10;6;306;312
25;Lleida;4;Lleida;18;Garrigues;25180;Puiggròs;1;1;;232;86;126;165;67;4;9;152;161
43;Tarragona;6;Camp de Tarragona;1;Alt Camp;43119;Puigpelat;1;1;;843;333;481;621;222;8;20;593;613
8;Barcelona;2;Catalunya Central;14;Berguedà;08175;Puig-reig;1;1;;1730;601;840;1121;609;33;48;1040;1088
8;Barcelona;2;Catalunya Central;14;Berguedà;08175;Puig-reig;1;2;;1147;384;611;796;351;13;37;746;783
8;Barcelona;2;Catalunya Central;14;Berguedà;08175;Puig-reig;2;1;;501;195;277;372;129;4;9;359;368
25;Lleida;4;Lleida;38;Urgell;25181;Puigverd d'Agramunt;1;1;;216;105;140;180;36;2;3;175;178
25;Lleida;4;Lleida;33;Segrià;25182;Puigverd de Lleida;1;1;;1054;436;636;813;241;1;12;800;812
8;Barcelona;2;Catalunya Central;6;Anoia;08176;Pujalt;1;1;;160;71;93;118;42;0;9;109;118
8;Barcelona;2;Catalunya Central;14;Berguedà;08177;Quar, la;1;1;;39;19;24;32;7;2;1;29;30
17;Girona;3;Girona;20;Gironès;17142;Quart;1;1;;1084;487;653;860;224;5;11;844;855
17;Girona;3;Girona;20;Gironès;17142;Quart;1;2;;1613;713;951;1244;369;6;9;1229;1238
17;Girona;3;Girona;31;Ripollès;17043;Queralbs;1;1;;169;72;112;148;21;1;0;147;147
43;Tarragona;6;Camp de Tarragona;1;Alt Camp;43120;Querol;1;1;;432;188;250;303;129;4;5;294;299
17;Girona;3;Girona;2;Alt Empordà;17143;Rabós;1;1;;165;89;121;138;27;3;0;135;135
8;Barcelona;2;Catalunya Central;7;Bages;08178;Rajadell;1;1;;453;221;280;373;80;2;5;366;371
43;Tarragona;7;Terres de l'Ebre;30;Ribera d'Ebre;43121;Rasquera;1;1;;614;304;433;518;96;15;8;495;503
17;Girona;3;Girona;10;Baix Empordà;17144;Regencós;1;1;;218;90;137;170;48;1;2;167;169
8;Barcelona;1;Barcelona;40;Vallès Occidental;08179;Rellinars;1;1;;617;229;371;470;147;3;9;458;467
43;Tarragona;6;Camp de Tarragona;36;Tarragonès;43122;Renau;1;1;;114;52;74;97;17;0;0;97;97
43;Tarragona;6;Camp de Tarragona;8;Baix Camp;43123;Reus;1;1;;773;298;371;475;298;3;2;470;472
43;Tarragona;6;Camp de Tarragona;8;Baix Camp;43123;Reus;1;2;;1327;553;690;898;429;3;8;887;895
43;Tarragona;6;Camp de Tarragona;8;Baix Camp;43123;Reus;1;3;;1067;410;540;687;380;1;5;681;686
43;Tarragona;6;Camp de Tarragona;8;Baix Camp;43123;Reus;10;1;;1674;551;801;1050;624;7;14;1029;1043
43;Tarragona;6;Camp de Tarragona;8;Baix Camp;43123;Reus;2;1;;604;201;277;345;259;1;7;337;344
43;Tarragona;6;Camp de Tarragona;8;Baix Camp;43123;Reus;2;10;;1501;566;772;950;551;2;5;943;948
43;Tarragona;6;Camp de Tarragona;8;Baix Camp;43123;Reus;2;11;;704;238;303;373;331;0;2;371;373
43;Tarragona;6;Camp de Tarragona;8;Baix Camp;43123;Reus;2;12;;1002;334;496;630;372;1;2;627;629
43;Tarragona;6;Camp de Tarragona;8;Baix Camp;43123;Reus;2;13;;806;311;409;502;304;0;1;501;502
43;Tarragona;6;Camp de Tarragona;8;Baix Camp;43123;Reus;2;14;;562;246;332;407;155;1;4;402;406
43;Tarragona;6;Camp de Tarragona;8;Baix Camp;43123;Reus;2;15;;748;294;420;554;194;2;5;547;552
43;Tarragona;6;Camp de Tarragona;8;Baix Camp;43123;Reus;2;2;;1396;534;707;875;521;7;4;864;868
43;Tarragona;6;Camp de Tarragona;8;Baix Camp;43123;Reus;2;3;;800;334;439;541;259;0;5;536;541
43;Tarragona;6;Camp de Tarragona;8;Baix Camp;43123;Reus;2;4;;1066;390;506;617;449;2;2;613;615
43;Tarragona;6;Camp de Tarragona;8;Baix Camp;43123;Reus;2;6;;1565;512;719;969;596;1;3;965;968
43;Tarragona;6;Camp de Tarragona;8;Baix Camp;43123;Reus;2;7;;1234;465;654;789;445;1;5;783;788
43;Tarragona;6;Camp de Tarragona;8;Baix Camp;43123;Reus;2;8;;783;250;356;452;331;3;1;448;449
43;Tarragona;6;Camp de Tarragona;8;Baix Camp;43123;Reus;2;9;;726;308;428;505;221;1;7;497;504
43;Tarragona;6;Camp de Tarragona;8;Baix Camp;43123;Reus;3;1;;784;267;391;476;308;4;5;467;472
43;Tarragona;6;Camp de Tarragona;8;Baix Camp;43123;Reus;3;10;;1059;346;457;570;489;5;1;564;565
43;Tarragona;6;Camp de Tarragona;8;Baix Camp;43123;Reus;3;11;;1640;551;717;888;752;2;5;881;886
43;Tarragona;6;Camp de Tarragona;8;Baix Camp;43123;Reus;3;12;;851;280;371;452;399;1;1;450;451
43;Tarragona;6;Camp de Tarragona;8;Baix Camp;43123;Reus;3;13;;947;300;416;531;416;1;1;529;530
43;Tarragona;6;Camp de Tarragona;8;Baix Camp;43123;Reus;3;3;;755;285;376;437;318;3;4;430;434
43;Tarragona;6;Camp de Tarragona;8;Baix Camp;43123;Reus;3;4;;987;371;480;592;395;3;2;587;589
43;Tarragona;6;Camp de Tarragona;8;Baix Camp;43123;Reus;3;5;;949;306;405;508;441;1;3;504;507
43;Tarragona;6;Camp de Tarragona;8;Baix Camp;43123;Reus;3;7;;1151;388;555;702;449;5;10;687;697
43;Tarragona;6;Camp de Tarragona;8;Baix Camp;43123;Reus;3;8;;1243;496;633;780;463;7;4;769;773
43;Tarragona;6;Camp de Tarragona;8;Baix Camp;43123;Reus;3;9;;755;248;393;415;340;3;8;404;412
43;Tarragona;6;Camp de Tarragona;8;Baix Camp;43123;Reus;4;2;;983;407;504;593;390;0;4;589;593
43;Tarragona;6;Camp de Tarragona;8;Baix Camp;43123;Reus;4;3;;1382;487;635;789;593;6;3;780;783
43;Tarragona;6;Camp de Tarragona;8;Baix Camp;43123;Reus;4;4;;1020;351;458;572;448;1;5;566;571
43;Tarragona;6;Camp de Tarragona;8;Baix Camp;43123;Reus;4;5;;608;247;312;395;213;1;4;390;394
43;Tarragona;6;Camp de Tarragona;8;Baix Camp;43123;Reus;4;7;;952;289;384;505;447;1;3;501;504
43;Tarragona;6;Camp de Tarragona;8;Baix Camp;43123;Reus;4;8;;1107;380;495;637;470;4;4;629;633
43;Tarragona;6;Camp de Tarragona;8;Baix Camp;43123;Reus;5;1;;1200;410;551;691;509;7;7;677;684
43;Tarragona;6;Camp de Tarragona;8;Baix Camp;43123;Reus;5;2;;1431;537;683;886;545;6;4;876;880
43;Tarragona;6;Camp de Tarragona;8;Baix Camp;43123;Reus;5;3;;624;204;247;288;336;3;2;283;285
43;Tarragona;6;Camp de Tarragona;8;Baix Camp;43123;Reus;5;4;;1286;459;636;809;477;3;0;806;806
43;Tarragona;6;Camp de Tarragona;8;Baix Camp;43123;Reus;5;5;;1037;360;452;541;496;6;10;525;535
43;Tarragona;6;Camp de Tarragona;8;Baix Camp;43123;Reus;5;7;;1053;371;524;692;361;1;6;685;691
43;Tarragona;6;Camp de Tarragona;8;Baix Camp;43123;Reus;6;1;;661;191;334;412;249;0;4;408;412
43;Tarragona;6;Camp de Tarragona;8;Baix Camp;43123;Reus;6;11;;1316;569;749;983;333;3;8;972;980
43;Tarragona;6;Camp de Tarragona;8;Baix Camp;43123;Reus;6;12;;965;366;497;651;314;2;7;642;649
43;Tarragona;6;Camp de Tarragona;8;Baix Camp;43123;Reus;6;13;;668;250;341;439;229;0;9;430;439
43;Tarragona;6;Camp de Tarragona;8;Baix Camp;43123;Reus;6;2;;1047;409;612;764;283;2;1;761;762
43;Tarragona;6;Camp de Tarragona;8;Baix Camp;43123;Reus;6;3;;1406;588;811;1046;360;3;7;1036;1043
43;Tarragona;6;Camp de Tarragona;8;Baix Camp;43123;Reus;6;4;;1366;662;872;1051;315;4;3;1044;1047
43;Tarragona;6;Camp de Tarragona;8;Baix Camp;43123;Reus;6;5;;1383;462;644;801;582;1;3;797;800
43;Tarragona;6;Camp de Tarragona;8;Baix Camp;43123;Reus;6;6;;1940;788;1017;1378;562;4;10;1364;1374
43;Tarragona;6;Camp de Tarragona;8;Baix Camp;43123;Reus;6;7;;924;371;480;603;321;4;6;593;599
43;Tarragona;6;Camp de Tarragona;8;Baix Camp;43123;Reus;6;8;;935;340;468;574;361;3;1;570;571
43;Tarragona;6;Camp de Tarragona;8;Baix Camp;43123;Reus;6;9;;1149;380;484;629;520;4;5;620;625
43;Tarragona;6;Camp de Tarragona;8;Baix Camp;43123;Reus;7;1;;1146;228;325;394;752;1;2;391;393
43;Tarragona;6;Camp de Tarragona;8;Baix Camp;43123;Reus;7;2;;1479;284;442;590;889;1;3;586;589
43;Tarragona;6;Camp de Tarragona;8;Baix Camp;43123;Reus;7;3;;1711;536;739;935;776;4;7;924;931
43;Tarragona;6;Camp de Tarragona;8;Baix Camp;43123;Reus;7;5;;1376;467;587;819;557;4;3;812;815
43;Tarragona;6;Camp de Tarragona;8;Baix Camp;43123;Reus;8;1;;724;206;292;362;362;3;5;354;359
43;Tarragona;6;Camp de Tarragona;8;Baix Camp;43123;Reus;8;2;;1017;293;395;524;493;1;1;522;523
43;Tarragona;6;Camp de Tarragona;8;Baix Camp;43123;Reus;8;3;;1046;394;518;667;379;5;5;657;662
43;Tarragona;6;Camp de Tarragona;8;Baix Camp;43123;Reus;8;4;;914;312;427;553;361;4;1;548;549
43;Tarragona;6;Camp de Tarragona;8;Baix Camp;43123;Reus;8;5;;998;338;478;616;382;1;5;610;615
43;Tarragona;6;Camp de Tarragona;8;Baix Camp;43123;Reus;8;6;;1468;521;736;961;507;3;4;954;958
43;Tarragona;6;Camp de Tarragona;8;Baix Camp;43123;Reus;8;7;;2126;703;994;1323;803;4;16;1303;1319
43;Tarragona;6;Camp de Tarragona;8;Baix Camp;43123;Reus;9;1;;1165;442;625;803;362;2;5;796;801
43;Tarragona;6;Camp de Tarragona;8;Baix Camp;43123;Reus;9;2;;642;147;205;284;358;1;1;282;283
25;Lleida;5;Alt Pirineu i territori d'Aran;26;Pallars Sobirà;25183;Rialp;1;1;;534;207;297;414;120;5;16;393;409
43;Tarragona;6;Camp de Tarragona;1;Alt Camp;43124;Riba, la;1;1;;470;184;278;338;132;29;22;287;309
43;Tarragona;7;Terres de l'Ebre;30;Ribera d'Ebre;43125;Riba-roja d'Ebre;1;1;;903;391;566;724;179;52;22;650;672
25;Lleida;4;Lleida;32;Segarra;25905;Ribera d'Ondara;1;1;;368;169;242;313;55;3;6;304;310
25;Lleida;5;Alt Pirineu i territori d'Aran;4;Alt Urgell;25185;Ribera d'Urgellet;1;1;;689;278;399;478;211;4;8;466;474
17;Girona;3;Girona;31;Ripollès;17145;Ribes de Freser;1;1;;637;250;344;464;173;12;18;434;452
17;Girona;3;Girona;31;Ripollès;17145;Ribes de Freser;1;2;;791;314;431;582;209;23;19;540;559
17;Girona;3;Girona;34;Selva;17146;Riells i Viabrea;1;1;;1475;511;767;1016;459;4;13;999;1012
17;Girona;3;Girona;34;Selva;17146;Riells i Viabrea;1;2;;1661;608;867;1087;574;10;17;1060;1077
43;Tarragona;6;Camp de Tarragona;36;Tarragonès;43126;Riera de Gaià, la;1;1;;1222;522;746;929;293;3;19;907;926
25;Lleida;2;Catalunya Central;35;Solsonès;25186;Riner;1;1;;209;105;153;187;22;2;9;176;185
17;Girona;3;Girona;31;Ripollès;17147;Ripoll;1;1;;1094;379;532;684;410;6;11;667;678
17;Girona;3;Girona;31;Ripollès;17147;Ripoll;2;1;;591;227;341;426;165;3;20;403;423
17;Girona;3;Girona;31;Ripollès;17147;Ripoll;2;2;;609;194;325;372;237;5;10;357;367
17;Girona;3;Girona;31;Ripollès;17147;Ripoll;3;1;;1006;343;576;637;369;10;9;618;627
17;Girona;3;Girona;31;Ripollès;17147;Ripoll;3;2;;646;251;383;462;184;2;4;456;460
17;Girona;3;Girona;31;Ripollès;17147;Ripoll;3;3;;1635;586;861;1159;476;10;25;1124;1149
17;Girona;3;Girona;31;Ripollès;17147;Ripoll;3;4;;1424;487;738;950;474;8;23;919;942
17;Girona;3;Girona;31;Ripollès;17147;Ripoll;4;1;;975;353;515;688;287;5;17;666;683
8;Barcelona;1;Barcelona;40;Vallès Occidental;08180;Ripollet;1;1;;1567;508;702;928;639;1;1;926;927
8;Barcelona;1;Barcelona;40;Vallès Occidental;08180;Ripollet;1;10;;1009;365;541;697;312;1;3;693;696
8;Barcelona;1;Barcelona;40;Vallès Occidental;08180;Ripollet;1;11;;1614;509;892;1057;557;1;18;1038;1056
8;Barcelona;1;Barcelona;40;Vallès Occidental;08180;Ripollet;1;12;;1394;436;697;906;488;4;8;894;902
8;Barcelona;1;Barcelona;40;Vallès Occidental;08180;Ripollet;1;13;;1550;536;802;1045;505;5;6;1034;1040
8;Barcelona;1;Barcelona;40;Vallès Occidental;08180;Ripollet;1;2;;1460;534;760;971;489;4;7;960;967
8;Barcelona;1;Barcelona;40;Vallès Occidental;08180;Ripollet;1;3;;1313;496;685;837;476;2;6;829;835
8;Barcelona;1;Barcelona;40;Vallès Occidental;08180;Ripollet;1;4;;1395;446;647;819;576;5;5;809;814
8;Barcelona;1;Barcelona;40;Vallès Occidental;08180;Ripollet;1;5;;1576;489;709;889;687;1;2;886;888
8;Barcelona;1;Barcelona;40;Vallès Occidental;08180;Ripollet;1;6;;1135;394;557;683;452;1;1;681;682
8;Barcelona;1;Barcelona;40;Vallès Occidental;08180;Ripollet;1;7;;1629;559;790;941;688;10;6;925;931
8;Barcelona;1;Barcelona;40;Vallès Occidental;08180;Ripollet;1;8;;1831;563;774;1049;782;6;12;1031;1043
8;Barcelona;1;Barcelona;40;Vallès Occidental;08180;Ripollet;1;9;;1262;480;677;867;395;1;2;864;866
8;Barcelona;1;Barcelona;40;Vallès Occidental;08180;Ripollet;2;1;;1220;419;577;720;500;12;4;704;708
8;Barcelona;1;Barcelona;40;Vallès Occidental;08180;Ripollet;2;2;;1519;464;713;933;586;6;5;922;927
8;Barcelona;1;Barcelona;40;Vallès Occidental;08180;Ripollet;2;3;;1609;513;615;850;759;10;8;832;840
8;Barcelona;1;Barcelona;40;Vallès Occidental;08180;Ripollet;2;4;;1247;487;670;782;465;3;6;773;779
8;Barcelona;1;Barcelona;40;Vallès Occidental;08180;Ripollet;2;5;;864;250;332;414;450;3;1;410;411
8;Barcelona;1;Barcelona;40;Vallès Occidental;08180;Ripollet;2;6;;1150;418;533;667;483;2;6;659;665
8;Barcelona;1;Barcelona;40;Vallès Occidental;08180;Ripollet;2;7;;865;311;397;482;383;5;8;469;477
17;Girona;3;Girona;34;Selva;17148;Riudarenes;1;1;;1556;651;913;1111;445;17;35;1059;1094
17;Girona;3;Girona;19;Garrotxa;17149;Riudaura;1;1;;368;172;239;309;59;20;21;268;289
43;Tarragona;6;Camp de Tarragona;8;Baix Camp;43127;Riudecanyes;1;1;;783;387;524;635;148;5;10;620;630
25;Lleida;5;Alt Pirineu i territori d'Aran;15;Cerdanya;25913;Riu de Cerdanya;1;1;;86;57;72;83;3;4;0;79;79
43;Tarragona;6;Camp de Tarragona;8;Baix Camp;43128;Riudecols;1;1;;912;408;607;732;180;19;47;666;713
17;Girona;3;Girona;34;Selva;17150;Riudellots de la Selva;1;1;;1466;696;975;1202;264;25;58;1119;1177
43;Tarragona;6;Camp de Tarragona;8;Baix Camp;43129;Riudoms;1;1;;945;357;535;676;269;21;8;647;655
43;Tarragona;6;Camp de Tarragona;8;Baix Camp;43129;Riudoms;2;1;;594;255;354;438;156;4;6;428;434
43;Tarragona;6;Camp de Tarragona;8;Baix Camp;43129;Riudoms;2;2;;1812;779;1021;1280;532;15;15;1250;1265
43;Tarragona;6;Camp de Tarragona;8;Baix Camp;43129;Riudoms;2;3;;1369;537;730;945;424;16;29;900;929
17;Girona;3;Girona;2;Alt Empordà;17151;Riumors;1;1;;187;34;91;127;60;14;21;92;113
8;Barcelona;1;Barcelona;41;Vallès Oriental;08181;Roca del Vallès, la;1;1;;1193;421;594;783;410;10;5;768;773
8;Barcelona;1;Barcelona;41;Vallès Oriental;08181;Roca del Vallès, la;1;2;;800;277;413;535;265;2;10;523;533
8;Barcelona;1;Barcelona;41;Vallès Oriental;08181;Roca del Vallès, la;1;3;;2056;669;962;1256;800;14;10;1232;1242
8;Barcelona;1;Barcelona;41;Vallès Oriental;08181;Roca del Vallès, la;1;4;;1660;544;841;1058;602;9;4;1045;1049
8;Barcelona;1;Barcelona;41;Vallès Oriental;08181;Roca del Vallès, la;1;5;;2391;826;1222;1666;725;19;25;1622;1647
43;Tarragona;6;Camp de Tarragona;16;Conca de Barberà;43130;Rocafort de Queralt;1;1;;178;93;119;133;45;3;6;124;130
43;Tarragona;6;Camp de Tarragona;36;Tarragonès;43131;Roda de Berà;1;1;;2063;739;987;1269;794;13;9;1247;1256
43;Tarragona;6;Camp de Tarragona;36;Tarragonès;43131;Roda de Berà;1;2;;1340;435;605;761;579;0;5;756;761
43;Tarragona;6;Camp de Tarragona;36;Tarragonès;43131;Roda de Berà;1;3;;1415;507;787;951;464;3;5;943;948
8;Barcelona;2;Catalunya Central;24;Osona;08183;Roda de Ter;1;1;;1420;500;742;950;470;9;17;924;941
8;Barcelona;2;Catalunya Central;24;Osona;08183;Roda de Ter;1;2;;1229;437;684;909;320;6;23;880;903
8;Barcelona;2;Catalunya Central;24;Osona;08183;Roda de Ter;1;3;;1076;401;563;712;364;7;19;686;705
8;Barcelona;2;Catalunya Central;24;Osona;08183;Roda de Ter;2;1;;856;307;465;591;265;4;20;567;587
43;Tarragona;6;Camp de Tarragona;1;Alt Camp;43132;Rodonyà;1;1;;374;148;215;286;88;2;15;269;284
43;Tarragona;7;Terres de l'Ebre;9;Baix Ebre;43133;Roquetes;1;1;;959;334;468;605;354;7;11;587;598
43;Tarragona;7;Terres de l'Ebre;9;Baix Ebre;43133;Roquetes;1;2;;1252;469;636;827;425;13;15;799;814
43;Tarragona;7;Terres de l'Ebre;9;Baix Ebre;43133;Roquetes;2;1;;1702;675;924;1151;551;20;11;1120;1131
43;Tarragona;7;Terres de l'Ebre;9;Baix Ebre;43133;Roquetes;2;2;;1732;632;824;1048;684;13;26;1009;1035
17;Girona;3;Girona;2;Alt Empordà;17152;Roses;1;1;;1149;363;509;659;490;2;2;655;657
17;Girona;3;Girona;2;Alt Empordà;17152;Roses;1;2;;1110;409;575;687;423;4;5;678;683
17;Girona;3;Girona;2;Alt Empordà;17152;Roses;1;3;;1062;218;308;381;681;2;2;377;379
17;Girona;3;Girona;2;Alt Empordà;17152;Roses;1;4;;1181;439;626;758;423;5;7;746;753
17;Girona;3;Girona;2;Alt Empordà;17152;Roses;1;5;;858;254;384;506;352;2;7;497;504
17;Girona;3;Girona;2;Alt Empordà;17152;Roses;1;6;;1467;473;683;813;654;4;2;807;809
17;Girona;3;Girona;2;Alt Empordà;17152;Roses;2;1;;923;341;470;575;348;3;6;566;572
17;Girona;3;Girona;2;Alt Empordà;17152;Roses;2;2;;1389;487;667;827;562;7;7;813;820
17;Girona;3;Girona;2;Alt Empordà;17152;Roses;2;3;;842;287;420;496;346;6;15;475;490
17;Girona;3;Girona;2;Alt Empordà;17152;Roses;2;4;;809;255;430;565;244;3;3;559;562
17;Girona;3;Girona;2;Alt Empordà;17152;Roses;2;5;;1008;355;461;590;418;0;2;588;590
25;Lleida;4;Lleida;33;Segrià;25189;Rosselló;1;1;;2185;753;1128;1442;743;11;32;1399;1431
43;Tarragona;6;Camp de Tarragona;1;Alt Camp;43134;Rourell, el;1;1;;283;111;160;207;76;7;10;190;200
8;Barcelona;1;Barcelona;40;Vallès Occidental;08184;Rubí;1;1;;1293;442;616;805;488;1;1;803;804
8;Barcelona;1;Barcelona;40;Vallès Occidental;08184;Rubí;1;2;;1332;456;525;726;606;6;5;715;720
8;Barcelona;1;Barcelona;40;Vallès Occidental;08184;Rubí;1;3;;1173;405;579;746;427;1;0;745;745
8;Barcelona;1;Barcelona;40;Vallès Occidental;08184;Rubí;1;4;;1285;434;648;866;419;2;1;863;864
8;Barcelona;1;Barcelona;40;Vallès Occidental;08184;Rubí;2;1;;1955;623;886;1112;843;3;7;1102;1109
8;Barcelona;1;Barcelona;40;Vallès Occidental;08184;Rubí;2;3;;1760;471;747;924;836;5;5;914;919
8;Barcelona;1;Barcelona;40;Vallès Occidental;08184;Rubí;2;4;;1765;505;764;1029;736;0;5;1024;1029
8;Barcelona;1;Barcelona;40;Vallès Occidental;08184;Rubí;2;5;;933;246;348;439;494;3;1;435;436
8;Barcelona;1;Barcelona;40;Vallès Occidental;08184;Rubí;2;6;;1669;416;605;792;877;2;1;789;790
8;Barcelona;1;Barcelona;40;Vallès Occidental;08184;Rubí;3;1;;1388;426;636;854;534;4;5;845;850
8;Barcelona;1;Barcelona;40;Vallès Occidental;08184;Rubí;3;3;;1309;418;567;656;653;1;0;655;655
8;Barcelona;1;Barcelona;40;Vallès Occidental;08184;Rubí;3;4;;1414;397;586;714;700;2;4;708;712
8;Barcelona;1;Barcelona;40;Vallès Occidental;08184;Rubí;3;5;;1498;550;747;873;625;4;5;864;869
8;Barcelona;1;Barcelona;40;Vallès Occidental;08184;Rubí;3;6;;1449;496;707;833;616;4;4;825;829
8;Barcelona;1;Barcelona;40;Vallès Occidental;08184;Rubí;3;7;;1280;448;624;787;493;4;4;779;783
8;Barcelona;1;Barcelona;40;Vallès Occidental;08184;Rubí;3;8;;928;283;386;448;480;5;1;442;443
8;Barcelona;1;Barcelona;40;Vallès Occidental;08184;Rubí;3;9;;1623;722;991;1145;478;2;3;1140;1143
8;Barcelona;1;Barcelona;40;Vallès Occidental;08184;Rubí;4;1;;1114;414;578;718;396;1;3;714;717
8;Barcelona;1;Barcelona;40;Vallès Occidental;08184;Rubí;4;10;;1850;510;773;975;875;4;4;967;971
8;Barcelona;1;Barcelona;40;Vallès Occidental;08184;Rubí;4;11;;1710;573;754;942;768;4;2;936;938
8;Barcelona;1;Barcelona;40;Vallès Occidental;08184;Rubí;4;12;;1224;377;546;707;517;0;8;699;707
8;Barcelona;1;Barcelona;40;Vallès Occidental;08184;Rubí;4;13;;1531;450;642;852;679;2;2;848;850
8;Barcelona;1;Barcelona;40;Vallès Occidental;08184;Rubí;4;14;;1400;423;618;799;601;1;3;795;798
8;Barcelona;1;Barcelona;40;Vallès Occidental;08184;Rubí;4;15;;1147;359;545;669;478;3;4;662;666
8;Barcelona;1;Barcelona;40;Vallès Occidental;08184;Rubí;4;16;;1682;482;690;923;759;0;4;919;923
8;Barcelona;1;Barcelona;40;Vallès Occidental;08184;Rubí;4;18;;914;332;434;550;364;0;2;548;550
8;Barcelona;1;Barcelona;40;Vallès Occidental;08184;Rubí;4;19;;946;300;424;524;422;3;2;519;521
8;Barcelona;1;Barcelona;40;Vallès Occidental;08184;Rubí;4;2;;990;339;494;644;346;1;6;637;643
8;Barcelona;1;Barcelona;40;Vallès Occidental;08184;Rubí;4;20;;936;292;422;529;407;1;5;523;528
8;Barcelona;1;Barcelona;40;Vallès Occidental;08184;Rubí;4;21;;1361;493;697;880;481;1;2;877;879
8;Barcelona;1;Barcelona;40;Vallès Occidental;08184;Rubí;4;22;;1510;472;713;933;577;2;5;926;931
8;Barcelona;1;Barcelona;40;Vallès Occidental;08184;Rubí;4;23;;830;234;341;449;381;2;2;445;447
8;Barcelona;1;Barcelona;40;Vallès Occidental;08184;Rubí;4;24;;855;303;445;547;308;2;6;539;545
8;Barcelona;1;Barcelona;40;Vallès Occidental;08184;Rubí;4;25;;707;206;296;368;339;1;3;364;367
8;Barcelona;1;Barcelona;40;Vallès Occidental;08184;Rubí;4;26;;1717;469;704;923;794;1;4;918;922
8;Barcelona;1;Barcelona;40;Vallès Occidental;08184;Rubí;4;3;;1187;430;599;751;436;3;1;747;748
8;Barcelona;1;Barcelona;40;Vallès Occidental;08184;Rubí;4;4;;1635;508;718;905;730;1;5;899;904
8;Barcelona;1;Barcelona;40;Vallès Occidental;08184;Rubí;4;5;;1217;424;609;754;463;2;5;747;752
8;Barcelona;1;Barcelona;40;Vallès Occidental;08184;Rubí;4;6;;1223;456;609;763;460;1;3;759;762
8;Barcelona;1;Barcelona;40;Vallès Occidental;08184;Rubí;4;7;;1147;444;586;740;407;0;2;738;740
8;Barcelona;1;Barcelona;40;Vallès Occidental;08184;Rubí;4;8;;942;293;373;476;466;4;4;468;472
8;Barcelona;1;Barcelona;40;Vallès Occidental;08184;Rubí;4;9;;1390;444;621;795;595;1;1;793;794
8;Barcelona;8;Penedès;6;Anoia;08185;Rubió;1;1;;200;89;133;165;35;7;6;152;158
17;Girona;3;Girona;10;Baix Empordà;17153;Rupià;1;1;;199;73;118;157;42;3;22;132;154
8;Barcelona;2;Catalunya Central;24;Osona;08901;Rupit i Pruit;1;1;;242;124;165;203;39;22;17;164;181
8;Barcelona;1;Barcelona;40;Vallès Occidental;08187;Sabadell;1;1;;568;234;350;429;139;0;2;427;429
8;Barcelona;1;Barcelona;40;Vallès Occidental;08187;Sabadell;1;10;;963;320;512;680;283;1;1;678;679
8;Barcelona;1;Barcelona;40;Vallès Occidental;08187;Sabadell;1;11;;975;470;569;733;242;2;2;729;731
8;Barcelona;1;Barcelona;40;Vallès Occidental;08187;Sabadell;1;12;;881;348;472;630;251;3;2;625;627
8;Barcelona;1;Barcelona;40;Vallès Occidental;08187;Sabadell;1;13;;829;268;431;575;254;0;8;567;575
8;Barcelona;1;Barcelona;40;Vallès Occidental;08187;Sabadell;1;14;;1438;549;819;1070;368;8;6;1056;1062
8;Barcelona;1;Barcelona;40;Vallès Occidental;08187;Sabadell;1;15;;1231;522;750;959;272;7;4;948;952
8;Barcelona;1;Barcelona;40;Vallès Occidental;08187;Sabadell;1;16;;1608;552;904;1175;433;1;11;1163;1174
8;Barcelona;1;Barcelona;40;Vallès Occidental;08187;Sabadell;1;17;;1752;602;887;1131;621;1;10;1120;1130
8;Barcelona;1;Barcelona;40;Vallès Occidental;08187;Sabadell;1;18;;1444;510;699;905;539;4;4;897;901
8;Barcelona;1;Barcelona;40;Vallès Occidental;08187;Sabadell;1;19;;1663;609;834;1113;550;4;8;1101;1109
8;Barcelona;1;Barcelona;40;Vallès Occidental;08187;Sabadell;1;2;;966;377;560;722;244;1;9;712;721
8;Barcelona;1;Barcelona;40;Vallès Occidental;08187;Sabadell;1;20;;1237;457;614;828;409;5;2;821;823
8;Barcelona;1;Barcelona;40;Vallès Occidental;08187;Sabadell;1;21;;877;320;457;554;323;3;1;550;551
8;Barcelona;1;Barcelona;40;Vallès Occidental;08187;Sabadell;1;22;;1029;358;528;680;349;2;4;674;678
8;Barcelona;1;Barcelona;40;Vallès Occidental;08187;Sabadell;1;23;;1116;386;531;686;430;2;5;679;684
8;Barcelona;1;Barcelona;40;Vallès Occidental;08187;Sabadell;1;24;;1205;432;596;739;466;0;2;737;739
8;Barcelona;1;Barcelona;40;Vallès Occidental;08187;Sabadell;1;25;;1113;464;627;747;366;6;2;739;741
8;Barcelona;1;Barcelona;40;Vallès Occidental;08187;Sabadell;1;26;;663;251;337;446;217;1;0;445;445
8;Barcelona;1;Barcelona;40;Vallès Occidental;08187;Sabadell;1;27;;509;194;280;349;160;2;4;343;347
8;Barcelona;1;Barcelona;40;Vallès Occidental;08187;Sabadell;1;28;;622;214;324;435;187;2;5;428;433
8;Barcelona;1;Barcelona;40;Vallès Occidental;08187;Sabadell;1;29;;977;336;528;632;345;1;5;626;631
8;Barcelona;1;Barcelona;40;Vallès Occidental;08187;Sabadell;1;3;;828;342;507;636;192;1;5;630;635
8;Barcelona;1;Barcelona;40;Vallès Occidental;08187;Sabadell;1;30;;896;357;510;671;225;3;7;661;668
8;Barcelona;1;Barcelona;40;Vallès Occidental;08187;Sabadell;1;31;;894;350;538;678;216;2;4;672;676
8;Barcelona;1;Barcelona;40;Vallès Occidental;08187;Sabadell;1;32;;916;315;490;666;250;3;3;660;663
8;Barcelona;1;Barcelona;40;Vallès Occidental;08187;Sabadell;1;33;;932;314;486;619;313;2;5;612;617
8;Barcelona;1;Barcelona;40;Vallès Occidental;08187;Sabadell;1;34;;1237;458;778;841;396;0;6;835;841
8;Barcelona;1;Barcelona;40;Vallès Occidental;08187;Sabadell;1;35;;870;340;470;583;287;0;1;582;583
8;Barcelona;1;Barcelona;40;Vallès Occidental;08187;Sabadell;1;36;;1052;383;608;809;243;2;8;799;807
8;Barcelona;1;Barcelona;40;Vallès Occidental;08187;Sabadell;1;37;;851;321;478;633;218;2;4;627;631
8;Barcelona;1;Barcelona;40;Vallès Occidental;08187;Sabadell;1;38;;751;297;416;530;221;2;3;525;528
8;Barcelona;1;Barcelona;40;Vallès Occidental;08187;Sabadell;1;4;;1767;678;998;1322;445;2;8;1312;1320
8;Barcelona;1;Barcelona;40;Vallès Occidental;08187;Sabadell;1;5;;1192;452;657;886;306;1;6;879;885
8;Barcelona;1;Barcelona;40;Vallès Occidental;08187;Sabadell;1;6;;1055;398;584;783;272;1;9;773;782
8;Barcelona;1;Barcelona;40;Vallès Occidental;08187;Sabadell;1;7;;1595;596;954;1169;426;4;3;1162;1165
8;Barcelona;1;Barcelona;40;Vallès Occidental;08187;Sabadell;1;8;;1864;723;1131;1400;464;4;12;1384;1396
8;Barcelona;1;Barcelona;40;Vallès Occidental;08187;Sabadell;1;9;;1184;446;653;877;307;2;6;869;875
8;Barcelona;1;Barcelona;40;Vallès Occidental;08187;Sabadell;2;1;;1234;568;777;976;258;0;7;969;976
8;Barcelona;1;Barcelona;40;Vallès Occidental;08187;Sabadell;2;10;;626;268;363;454;172;1;1;452;453
8;Barcelona;1;Barcelona;40;Vallès Occidental;08187;Sabadell;2;11;;605;135;189;228;377;1;0;227;227
8;Barcelona;1;Barcelona;40;Vallès Occidental;08187;Sabadell;2;12;;1292;402;544;648;644;0;5;643;648
8;Barcelona;1;Barcelona;40;Vallès Occidental;08187;Sabadell;2;13;;958;239;348;443;515;0;4;439;443
8;Barcelona;1;Barcelona;40;Vallès Occidental;08187;Sabadell;2;14;;880;214;303;353;527;0;2;351;353
8;Barcelona;1;Barcelona;40;Vallès Occidental;08187;Sabadell;2;15;;1040;366;494;619;421;4;4;611;615
8;Barcelona;1;Barcelona;40;Vallès Occidental;08187;Sabadell;2;16;;1190;486;700;894;296;1;8;885;893
8;Barcelona;1;Barcelona;40;Vallès Occidental;08187;Sabadell;2;17;;763;281;430;582;181;4;5;573;578
8;Barcelona;1;Barcelona;40;Vallès Occidental;08187;Sabadell;2;2;;1098;434;623;808;290;4;3;801;804
8;Barcelona;1;Barcelona;40;Vallès Occidental;08187;Sabadell;2;3;;1051;415;568;690;361;3;6;681;687
8;Barcelona;1;Barcelona;40;Vallès Occidental;08187;Sabadell;2;4;;1543;589;997;1125;418;1;6;1118;1124
8;Barcelona;1;Barcelona;40;Vallès Occidental;08187;Sabadell;2;5;;1337;494;724;931;406;1;2;928;930
8;Barcelona;1;Barcelona;40;Vallès Occidental;08187;Sabadell;2;6;;1318;453;666;827;491;6;3;818;821
8;Barcelona;1;Barcelona;40;Vallès Occidental;08187;Sabadell;2;7;;1283;520;613;883;400;1;7;875;882
8;Barcelona;1;Barcelona;40;Vallès Occidental;08187;Sabadell;2;8;;671;364;476;516;155;6;5;505;510
8;Barcelona;1;Barcelona;40;Vallès Occidental;08187;Sabadell;2;9;;942;377;558;690;252;2;4;684;688
8;Barcelona;1;Barcelona;40;Vallès Occidental;08187;Sabadell;3;1;;1154;386;502;674;480;3;3;668;671
8;Barcelona;1;Barcelona;40;Vallès Occidental;08187;Sabadell;3;10;;519;186;270;326;193;2;0;324;324
8;Barcelona;1;Barcelona;40;Vallès Occidental;08187;Sabadell;3;11;;869;268;390;456;413;4;0;452;452
8;Barcelona;1;Barcelona;40;Vallès Occidental;08187;Sabadell;3;12;;851;296;411;509;342;1;3;505;508
8;Barcelona;1;Barcelona;40;Vallès Occidental;08187;Sabadell;3;13;;816;300;374;473;343;1;7;465;472
8;Barcelona;1;Barcelona;40;Vallès Occidental;08187;Sabadell;3;14;;1157;394;527;657;500;3;1;653;654
8;Barcelona;1;Barcelona;40;Vallès Occidental;08187;Sabadell;3;15;;1146;384;518;630;516;1;2;627;629
8;Barcelona;1;Barcelona;40;Vallès Occidental;08187;Sabadell;3;16;;991;284;397;479;512;2;0;477;477
8;Barcelona;1;Barcelona;40;Vallès Occidental;08187;Sabadell;3;17;;747;259;338;403;344;2;4;397;401
8;Barcelona;1;Barcelona;40;Vallès Occidental;08187;Sabadell;3;18;;936;304;443;550;386;2;2;546;548
8;Barcelona;1;Barcelona;40;Vallès Occidental;08187;Sabadell;3;19;;692;290;379;458;234;0;0;458;458
8;Barcelona;1;Barcelona;40;Vallès Occidental;08187;Sabadell;3;2;;1034;335;457;559;475;1;3;555;558
8;Barcelona;1;Barcelona;40;Vallès Occidental;08187;Sabadell;3;20;;546;155;239;324;222;0;2;322;324
8;Barcelona;1;Barcelona;40;Vallès Occidental;08187;Sabadell;3;21;;958;296;409;492;466;0;1;491;492
8;Barcelona;1;Barcelona;40;Vallès Occidental;08187;Sabadell;3;22;;584;183;276;321;263;1;2;318;320
8;Barcelona;1;Barcelona;40;Vallès Occidental;08187;Sabadell;3;23;;1401;468;714;898;503;3;2;893;895
8;Barcelona;1;Barcelona;40;Vallès Occidental;08187;Sabadell;3;24;;1644;586;873;1080;564;3;1;1076;1077
8;Barcelona;1;Barcelona;40;Vallès Occidental;08187;Sabadell;3;25;;1212;502;670;815;397;2;2;811;813
8;Barcelona;1;Barcelona;40;Vallès Occidental;08187;Sabadell;3;26;;613;261;353;434;179;0;0;434;434
8;Barcelona;1;Barcelona;40;Vallès Occidental;08187;Sabadell;3;27;;549;171;241;305;244;0;0;305;305
8;Barcelona;1;Barcelona;40;Vallès Occidental;08187;Sabadell;3;3;;1177;377;520;621;556;3;2;616;618
8;Barcelona;1;Barcelona;40;Vallès Occidental;08187;Sabadell;3;4;;1166;391;494;644;522;0;3;641;644
8;Barcelona;1;Barcelona;40;Vallès Occidental;08187;Sabadell;3;5;;722;219;325;415;307;3;1;411;412
8;Barcelona;1;Barcelona;40;Vallès Occidental;08187;Sabadell;3;6;;724;240;358;450;274;0;2;448;450
8;Barcelona;1;Barcelona;40;Vallès Occidental;08187;Sabadell;3;7;;639;229;321;398;241;0;2;396;398
8;Barcelona;1;Barcelona;40;Vallès Occidental;08187;Sabadell;3;8;;946;243;365;508;438;1;1;506;507
8;Barcelona;1;Barcelona;40;Vallès Occidental;08187;Sabadell;3;9;;692;186;282;347;345;0;0;347;347
8;Barcelona;1;Barcelona;40;Vallès Occidental;08187;Sabadell;4;1;;1379;507;699;857;522;0;3;854;857
8;Barcelona;1;Barcelona;40;Vallès Occidental;08187;Sabadell;4;10;;967;355;465;577;390;4;4;569;573
8;Barcelona;1;Barcelona;40;Vallès Occidental;08187;Sabadell;4;11;;707;229;328;404;303;2;6;396;402
8;Barcelona;1;Barcelona;40;Vallès Occidental;08187;Sabadell;4;12;;734;226;332;403;331;3;1;399;400
8;Barcelona;1;Barcelona;40;Vallès Occidental;08187;Sabadell;4;13;;1366;420;619;768;598;2;0;766;766
8;Barcelona;1;Barcelona;40;Vallès Occidental;08187;Sabadell;4;14;;989;363;498;659;330;1;3;655;658
8;Barcelona;1;Barcelona;40;Vallès Occidental;08187;Sabadell;4;15;;658;219;288;344;314;2;2;340;342
8;Barcelona;1;Barcelona;40;Vallès Occidental;08187;Sabadell;4;16;;1533;522;736;937;596;0;3;934;937
8;Barcelona;1;Barcelona;40;Vallès Occidental;08187;Sabadell;4;17;;1376;451;608;748;628;2;4;742;746
8;Barcelona;1;Barcelona;40;Vallès Occidental;08187;Sabadell;4;18;;570;183;273;341;229;0;1;340;341
8;Barcelona;1;Barcelona;40;Vallès Occidental;08187;Sabadell;4;19;;946;245;373;459;487;2;1;456;457
8;Barcelona;1;Barcelona;40;Vallès Occidental;08187;Sabadell;4;2;;821;273;379;463;358;1;0;462;462
8;Barcelona;1;Barcelona;40;Vallès Occidental;08187;Sabadell;4;20;;666;210;293;354;312;1;1;352;353
8;Barcelona;1;Barcelona;40;Vallès Occidental;08187;Sabadell;4;21;;829;306;429;516;313;1;1;514;515
8;Barcelona;1;Barcelona;40;Vallès Occidental;08187;Sabadell;4;22;;715;306;347;436;279;2;0;434;434
8;Barcelona;1;Barcelona;40;Vallès Occidental;08187;Sabadell;4;23;;783;254;352;464;319;0;2;462;464
8;Barcelona;1;Barcelona;40;Vallès Occidental;08187;Sabadell;4;24;;790;282;413;517;273;0;2;515;517
8;Barcelona;1;Barcelona;40;Vallès Occidental;08187;Sabadell;4;25;;874;279;522;588;286;2;2;584;586
8;Barcelona;1;Barcelona;40;Vallès Occidental;08187;Sabadell;4;26;;914;253;399;570;344;1;1;568;569
8;Barcelona;1;Barcelona;40;Vallès Occidental;08187;Sabadell;4;27;;1283;458;685;894;389;1;2;891;893
8;Barcelona;1;Barcelona;40;Vallès Occidental;08187;Sabadell;4;28;;925;288;409;599;326;0;4;595;599
8;Barcelona;1;Barcelona;40;Vallès Occidental;08187;Sabadell;4;29;;974;289;436;606;368;1;6;599;605
8;Barcelona;1;Barcelona;40;Vallès Occidental;08187;Sabadell;4;3;;740;279;373;475;265;1;0;474;474
8;Barcelona;1;Barcelona;40;Vallès Occidental;08187;Sabadell;4;30;;1473;499;731;988;485;3;8;977;985
8;Barcelona;1;Barcelona;40;Vallès Occidental;08187;Sabadell;4;4;;1263;470;619;753;510;1;7;745;752
8;Barcelona;1;Barcelona;40;Vallès Occidental;08187;Sabadell;4;5;;1192;493;662;776;416;1;2;773;775
8;Barcelona;1;Barcelona;40;Vallès Occidental;08187;Sabadell;4;6;;1316;506;684;870;446;2;4;864;868
8;Barcelona;1;Barcelona;40;Vallès Occidental;08187;Sabadell;4;7;;894;302;446;568;326;1;4;563;567
8;Barcelona;1;Barcelona;40;Vallès Occidental;08187;Sabadell;4;8;;1526;602;762;1014;512;4;5;1005;1010
8;Barcelona;1;Barcelona;40;Vallès Occidental;08187;Sabadell;4;9;;918;340;521;670;248;0;3;667;670
8;Barcelona;1;Barcelona;40;Vallès Occidental;08187;Sabadell;5;1;;1184;413;535;699;485;2;2;695;697
8;Barcelona;1;Barcelona;40;Vallès Occidental;08187;Sabadell;5;11;;688;190;267;311;377;0;0;311;311
8;Barcelona;1;Barcelona;40;Vallès Occidental;08187;Sabadell;5;12;;851;277;371;455;396;4;4;447;451
8;Barcelona;1;Barcelona;40;Vallès Occidental;08187;Sabadell;5;13;;1170;330;470;610;560;4;0;606;606
8;Barcelona;1;Barcelona;40;Vallès Occidental;08187;Sabadell;5;14;;857;286;425;583;274;1;1;581;582
8;Barcelona;1;Barcelona;40;Vallès Occidental;08187;Sabadell;5;15;;1090;410;610;806;284;2;6;798;804
8;Barcelona;1;Barcelona;40;Vallès Occidental;08187;Sabadell;5;16;;1070;362;510;671;399;2;4;665;669
8;Barcelona;1;Barcelona;40;Vallès Occidental;08187;Sabadell;5;2;;1380;474;720;949;431;0;9;940;949
8;Barcelona;1;Barcelona;40;Vallès Occidental;08187;Sabadell;5;3;;1138;446;663;858;280;1;4;853;857
8;Barcelona;1;Barcelona;40;Vallès Occidental;08187;Sabadell;5;4;;680;273;394;496;184;1;2;493;495
8;Barcelona;1;Barcelona;40;Vallès Occidental;08187;Sabadell;5;5;;946;340;492;607;339;3;5;599;604
8;Barcelona;1;Barcelona;40;Vallès Occidental;08187;Sabadell;5;6;;868;333;482;608;260;0;3;605;608
8;Barcelona;1;Barcelona;40;Vallès Occidental;08187;Sabadell;5;7;;518;128;200;265;253;1;0;264;264
8;Barcelona;1;Barcelona;40;Vallès Occidental;08187;Sabadell;5;8;;731;191;303;379;352;2;0;377;377
8;Barcelona;1;Barcelona;40;Vallès Occidental;08187;Sabadell;5;9;;1216;432;586;741;475;0;5;736;741
8;Barcelona;1;Barcelona;40;Vallès Occidental;08187;Sabadell;6;1;;529;159;216;274;255;1;0;273;273
8;Barcelona;1;Barcelona;40;Vallès Occidental;08187;Sabadell;6;10;;610;164;227;269;341;0;2;267;269
8;Barcelona;1;Barcelona;40;Vallès Occidental;08187;Sabadell;6;11;;591;164;213;270;321;2;0;268;268
8;Barcelona;1;Barcelona;40;Vallès Occidental;08187;Sabadell;6;12;;712;234;314;358;354;3;1;354;355
8;Barcelona;1;Barcelona;40;Vallès Occidental;08187;Sabadell;6;13;;534;145;193;223;311;0;0;223;223
8;Barcelona;1;Barcelona;40;Vallès Occidental;08187;Sabadell;6;14;;1548;549;709;887;661;5;8;874;882
8;Barcelona;1;Barcelona;40;Vallès Occidental;08187;Sabadell;6;16;;1213;435;576;741;472;4;5;732;737
8;Barcelona;1;Barcelona;40;Vallès Occidental;08187;Sabadell;6;17;;760;249;347;425;335;1;4;420;424
8;Barcelona;1;Barcelona;40;Vallès Occidental;08187;Sabadell;6;18;;1018;313;444;553;465;2;1;550;551
8;Barcelona;1;Barcelona;40;Vallès Occidental;08187;Sabadell;6;2;;647;178;242;331;316;0;0;331;331
8;Barcelona;1;Barcelona;40;Vallès Occidental;08187;Sabadell;6;20;;841;291;391;481;360;1;0;480;480
8;Barcelona;1;Barcelona;40;Vallès Occidental;08187;Sabadell;6;21;;826;273;396;491;335;2;1;488;489
8;Barcelona;1;Barcelona;40;Vallès Occidental;08187;Sabadell;6;22;;1259;379;533;690;569;2;2;686;688
8;Barcelona;1;Barcelona;40;Vallès Occidental;08187;Sabadell;6;23;;1386;479;646;828;558;7;3;818;821
8;Barcelona;1;Barcelona;40;Vallès Occidental;08187;Sabadell;6;24;;744;271;357;431;313;0;4;427;431
8;Barcelona;1;Barcelona;40;Vallès Occidental;08187;Sabadell;6;25;;583;155;221;267;316;4;3;260;263
8;Barcelona;1;Barcelona;40;Vallès Occidental;08187;Sabadell;6;3;;893;292;384;466;427;1;1;464;465
8;Barcelona;1;Barcelona;40;Vallès Occidental;08187;Sabadell;6;4;;955;294;407;494;461;1;3;490;493
8;Barcelona;1;Barcelona;40;Vallès Occidental;08187;Sabadell;6;5;;794;245;349;429;365;4;4;421;425
8;Barcelona;1;Barcelona;40;Vallès Occidental;08187;Sabadell;6;6;;828;248;347;418;410;2;3;413;416
8;Barcelona;1;Barcelona;40;Vallès Occidental;08187;Sabadell;6;7;;592;142;204;253;339;2;0;251;251
8;Barcelona;1;Barcelona;40;Vallès Occidental;08187;Sabadell;6;8;;1191;464;589;747;444;5;3;739;742
8;Barcelona;1;Barcelona;40;Vallès Occidental;08187;Sabadell;6;9;;1221;361;476;586;635;0;3;583;586
8;Barcelona;1;Barcelona;40;Vallès Occidental;08187;Sabadell;7;1;;682;210;293;365;317;1;2;362;364
8;Barcelona;1;Barcelona;40;Vallès Occidental;08187;Sabadell;7;2;;993;251;393;483;510;1;2;480;482
8;Barcelona;1;Barcelona;40;Vallès Occidental;08187;Sabadell;7;3;;641;170;252;299;342;1;5;293;298
8;Barcelona;1;Barcelona;40;Vallès Occidental;08187;Sabadell;7;4;;570;190;254;312;258;3;0;309;309
8;Barcelona;1;Barcelona;40;Vallès Occidental;08187;Sabadell;7;5;;850;229;327;434;416;4;1;429;430
8;Barcelona;1;Barcelona;40;Vallès Occidental;08187;Sabadell;7;6;;559;167;239;311;248;4;0;307;307
8;Barcelona;1;Barcelona;40;Vallès Occidental;08187;Sabadell;7;7;;1002;268;386;522;480;3;2;517;519
8;Barcelona;1;Barcelona;40;Vallès Occidental;08187;Sabadell;7;8;;775;129;190;268;507;2;0;266;266
8;Barcelona;2;Catalunya Central;14;Berguedà;08188;Sagàs;1;1;;115;42;66;91;24;0;8;83;91
25;Lleida;5;Alt Pirineu i territori d'Aran;25;Pallars Jussà;25190;Salàs de Pallars;1;1;;262;107;169;220;42;10;4;206;210
8;Barcelona;2;Catalunya Central;14;Berguedà;08190;Saldes;1;1;;258;91;146;198;60;11;42;145;187
17;Girona;3;Girona;19;Garrotxa;17154;Sales de Llierca;1;1;;116;44;64;91;25;3;12;76;88
8;Barcelona;2;Catalunya Central;7;Bages;08191;Sallent;1;1;;962;364;492;637;325;10;26;601;627
8;Barcelona;2;Catalunya Central;7;Bages;08191;Sallent;1;3;;1116;463;640;795;321;8;40;747;787
8;Barcelona;2;Catalunya Central;7;Bages;08191;Sallent;1;4;;1024;394;532;692;332;21;37;634;671
8;Barcelona;2;Catalunya Central;7;Bages;08191;Sallent;1;5;;1128;466;645;806;322;17;43;746;789
8;Barcelona;2;Catalunya Central;7;Bages;08191;Sallent;1;6;;654;287;392;480;174;5;17;458;475
8;Barcelona;2;Catalunya Central;7;Bages;08191;Sallent;2;1;;432;210;268;309;123;6;9;294;303
43;Tarragona;6;Camp de Tarragona;36;Tarragonès;43135;Salomó;1;1;;347;155;212;254;93;25;19;210;229
43;Tarragona;6;Camp de Tarragona;36;Tarragonès;43905;Salou;1;1;;1973;535;790;1029;944;6;12;1011;1023
43;Tarragona;6;Camp de Tarragona;36;Tarragonès;43905;Salou;1;10;;1429;472;685;881;548;2;5;874;879
43;Tarragona;6;Camp de Tarragona;36;Tarragonès;43905;Salou;1;11;;1424;452;678;858;566;6;10;842;852
43;Tarragona;6;Camp de Tarragona;36;Tarragonès;43905;Salou;1;12;;1051;333;457;581;470;2;5;574;579
43;Tarragona;6;Camp de Tarragona;36;Tarragonès;43905;Salou;1;2;;1442;339;504;653;789;1;2;650;652
43;Tarragona;6;Camp de Tarragona;36;Tarragonès;43905;Salou;1;3;;771;220;338;448;323;2;2;444;446
43;Tarragona;6;Camp de Tarragona;36;Tarragonès;43905;Salou;1;4;;958;294;412;520;438;2;3;515;518
43;Tarragona;6;Camp de Tarragona;36;Tarragonès;43905;Salou;1;5;;843;289;382;503;340;1;9;493;502
43;Tarragona;6;Camp de Tarragona;36;Tarragonès;43905;Salou;1;6;;1863;422;656;850;1013;4;9;837;846
43;Tarragona;6;Camp de Tarragona;36;Tarragonès;43905;Salou;1;7;;1846;569;814;1026;820;3;12;1011;1023
43;Tarragona;6;Camp de Tarragona;36;Tarragonès;43905;Salou;1;8;;1222;394;553;754;468;3;3;748;751
43;Tarragona;6;Camp de Tarragona;36;Tarragonès;43905;Salou;1;9;;870;287;419;551;319;3;3;545;548
17;Girona;3;Girona;20;Gironès;17155;Salt;1;1;;970;422;575;690;280;3;6;681;687
17;Girona;3;Girona;20;Gironès;17155;Salt;1;2;;762;317;394;499;263;1;9;489;498
17;Girona;3;Girona;20;Gironès;17155;Salt;1;3;;1260;329;476;578;682;6;6;566;572
17;Girona;3;Girona;20;Gironès;17155;Salt;1;4;;1623;596;827;1002;621;2;1;999;1000
17;Girona;3;Girona;20;Gironès;17155;Salt;1;5;;1258;337;441;569;689;2;0;567;567
17;Girona;3;Girona;20;Gironès;17155;Salt;1;6;;899;267;381;451;448;3;5;443;448
17;Girona;3;Girona;20;Gironès;17155;Salt;1;8;;968;392;515;615;353;6;10;599;609
17;Girona;3;Girona;20;Gironès;17155;Salt;1;9;;708;310;428;507;201;2;6;499;505
17;Girona;3;Girona;20;Gironès;17155;Salt;2;1;;1075;350;480;585;490;2;3;580;583
17;Girona;3;Girona;20;Gironès;17155;Salt;2;2;;844;357;467;430;414;2;3;425;428
17;Girona;3;Girona;20;Gironès;17155;Salt;2;3;;1013;345;445;568;445;3;3;562;565
17;Girona;3;Girona;20;Gironès;17155;Salt;2;4;;1629;492;698;876;753;8;2;866;868
17;Girona;3;Girona;20;Gironès;17155;Salt;2;5;;725;304;388;484;241;1;2;481;483
17;Girona;3;Girona;20;Gironès;17155;Salt;2;6;;685;215;304;375;310;8;2;365;367
17;Girona;3;Girona;20;Gironès;17155;Salt;2;7;;1034;301;419;539;495;3;1;535;536
25;Lleida;4;Lleida;32;Segarra;25191;Sanaüja;1;1;;330;140;203;261;69;4;8;249;257
43;Tarragona;7;Terres de l'Ebre;22;Montsià;43138;Santa Bàrbara;1;1;;1410;526;755;1011;399;26;23;962;985
43;Tarragona;7;Terres de l'Ebre;22;Montsià;43138;Santa Bàrbara;2;1;;1274;475;641;869;405;9;17;843;860
8;Barcelona;2;Catalunya Central;24;Osona;08243;Santa Cecília de Voltregà;1;1;;155;61;97;125;30;2;4;119;123
8;Barcelona;1;Barcelona;11;Baix Llobregat;08244;Santa Coloma de Cervelló;1;1;;1719;661;918;1159;560;24;5;1130;1135
8;Barcelona;1;Barcelona;11;Baix Llobregat;08244;Santa Coloma de Cervelló;1;2;;591;272;374;450;141;10;7;433;440
8;Barcelona;1;Barcelona;11;Baix Llobregat;08244;Santa Coloma de Cervelló;1;3;;1821;708;969;1279;542;40;15;1224;1239
8;Barcelona;1;Barcelona;11;Baix Llobregat;08244;Santa Coloma de Cervelló;1;4;;1391;408;610;834;557;32;10;792;802
8;Barcelona;1;Barcelona;11;Baix Llobregat;08244;Santa Coloma de Cervelló;1;5;;561;200;273;355;206;2;1;352;353
17;Girona;3;Girona;34;Selva;17180;Santa Coloma de Farners;1;1;;1533;516;810;1002;531;16;23;963;986
17;Girona;3;Girona;34;Selva;17180;Santa Coloma de Farners;1;2;;1054;385;560;713;341;7;31;675;706
17;Girona;3;Girona;34;Selva;17180;Santa Coloma de Farners;1;3;;1535;562;759;1000;535;11;26;963;989
17;Girona;3;Girona;34;Selva;17180;Santa Coloma de Farners;1;4;;1828;706;961;1257;571;13;27;1217;1244
17;Girona;3;Girona;34;Selva;17180;Santa Coloma de Farners;1;5;;1294;370;698;856;438;4;21;831;852
17;Girona;3;Girona;34;Selva;17180;Santa Coloma de Farners;1;6;;1315;363;514;688;627;11;19;658;677
8;Barcelona;1;Barcelona;13;Barcelonès;08245;Santa Coloma de Gramenet;1;1;;793;340;457;584;209;1;5;578;583
8;Barcelona;1;Barcelona;13;Barcelonès;08245;Santa Coloma de Gramenet;1;10;;956;323;422;530;426;2;1;527;528
8;Barcelona;1;Barcelona;13;Barcelonès;08245;Santa Coloma de Gramenet;1;11;;793;262;362;449;344;1;0;448;448
8;Barcelona;1;Barcelona;13;Barcelonès;08245;Santa Coloma de Gramenet;1;12;;611;232;314;389;222;0;1;388;389
8;Barcelona;1;Barcelona;13;Barcelonès;08245;Santa Coloma de Gramenet;1;13;;1451;505;747;950;501;0;5;945;950
8;Barcelona;1;Barcelona;13;Barcelonès;08245;Santa Coloma de Gramenet;1;14;;872;306;436;589;283;3;2;584;586
8;Barcelona;1;Barcelona;13;Barcelonès;08245;Santa Coloma de Gramenet;1;15;;642;194;286;388;254;0;2;386;388
8;Barcelona;1;Barcelona;13;Barcelonès;08245;Santa Coloma de Gramenet;1;16;;696;274;372;479;217;3;3;473;476
8;Barcelona;1;Barcelona;13;Barcelonès;08245;Santa Coloma de Gramenet;1;17;;1194;433;551;695;499;1;5;689;694
8;Barcelona;1;Barcelona;13;Barcelonès;08245;Santa Coloma de Gramenet;1;18;;1027;383;495;661;366;1;1;659;660
8;Barcelona;1;Barcelona;13;Barcelonès;08245;Santa Coloma de Gramenet;1;19;;1143;438;570;735;408;3;1;731;732
8;Barcelona;1;Barcelona;13;Barcelonès;08245;Santa Coloma de Gramenet;1;2;;671;255;355;438;233;2;2;434;436
8;Barcelona;1;Barcelona;13;Barcelonès;08245;Santa Coloma de Gramenet;1;3;;904;326;437;537;367;2;3;532;535
8;Barcelona;1;Barcelona;13;Barcelonès;08245;Santa Coloma de Gramenet;1;4;;542;200;268;338;204;1;2;335;337
8;Barcelona;1;Barcelona;13;Barcelonès;08245;Santa Coloma de Gramenet;1;5;;623;233;296;365;258;0;1;364;365
8;Barcelona;1;Barcelona;13;Barcelonès;08245;Santa Coloma de Gramenet;1;6;;588;217;298;362;226;2;0;360;360
8;Barcelona;1;Barcelona;13;Barcelonès;08245;Santa Coloma de Gramenet;1;7;;905;293;384;485;420;1;4;480;484
8;Barcelona;1;Barcelona;13;Barcelonès;08245;Santa Coloma de Gramenet;1;9;;886;278;367;466;420;5;2;459;461
8;Barcelona;1;Barcelona;13;Barcelonès;08245;Santa Coloma de Gramenet;2;1;;727;279;362;445;282;1;0;444;444
8;Barcelona;1;Barcelona;13;Barcelonès;08245;Santa Coloma de Gramenet;2;10;;543;193;262;319;224;1;2;316;318
8;Barcelona;1;Barcelona;13;Barcelonès;08245;Santa Coloma de Gramenet;2;11;;931;283;416;505;426;3;0;502;502
8;Barcelona;1;Barcelona;13;Barcelonès;08245;Santa Coloma de Gramenet;2;2;;1153;409;550;703;450;3;6;694;700
8;Barcelona;1;Barcelona;13;Barcelonès;08245;Santa Coloma de Gramenet;2;3;;1264;402;571;713;551;2;5;706;711
8;Barcelona;1;Barcelona;13;Barcelonès;08245;Santa Coloma de Gramenet;2;4;;804;273;424;466;338;5;1;460;461
8;Barcelona;1;Barcelona;13;Barcelonès;08245;Santa Coloma de Gramenet;2;5;;850;302;412;505;345;4;3;498;501
8;Barcelona;1;Barcelona;13;Barcelonès;08245;Santa Coloma de Gramenet;2;6;;862;337;431;519;343;3;1;515;516
8;Barcelona;1;Barcelona;13;Barcelonès;08245;Santa Coloma de Gramenet;2;7;;1510;482;690;884;626;0;7;877;884
8;Barcelona;1;Barcelona;13;Barcelonès;08245;Santa Coloma de Gramenet;2;8;;1011;373;479;595;416;0;4;591;595
8;Barcelona;1;Barcelona;13;Barcelonès;08245;Santa Coloma de Gramenet;2;9;;875;290;401;500;375;2;4;494;498
8;Barcelona;1;Barcelona;13;Barcelonès;08245;Santa Coloma de Gramenet;3;1;;616;197;293;359;257;1;5;353;358
8;Barcelona;1;Barcelona;13;Barcelonès;08245;Santa Coloma de Gramenet;3;10;;540;184;253;338;202;1;0;337;337
8;Barcelona;1;Barcelona;13;Barcelonès;08245;Santa Coloma de Gramenet;3;11;;836;276;417;517;319;1;0;516;516
8;Barcelona;1;Barcelona;13;Barcelonès;08245;Santa Coloma de Gramenet;3;12;;1157;434;572;720;437;2;3;715;718
8;Barcelona;1;Barcelona;13;Barcelonès;08245;Santa Coloma de Gramenet;3;13;;1250;434;582;772;478;5;2;765;767
8;Barcelona;1;Barcelona;13;Barcelonès;08245;Santa Coloma de Gramenet;3;14;;942;308;433;525;417;2;4;519;523
8;Barcelona;1;Barcelona;13;Barcelonès;08245;Santa Coloma de Gramenet;3;15;;1023;360;541;678;345;4;4;670;674
8;Barcelona;1;Barcelona;13;Barcelonès;08245;Santa Coloma de Gramenet;3;16;;730;242;361;441;289;1;0;440;440
8;Barcelona;1;Barcelona;13;Barcelonès;08245;Santa Coloma de Gramenet;3;17;;555;180;254;310;245;0;0;310;310
8;Barcelona;1;Barcelona;13;Barcelonès;08245;Santa Coloma de Gramenet;3;2;;573;179;266;344;229;2;1;341;342
8;Barcelona;1;Barcelona;13;Barcelonès;08245;Santa Coloma de Gramenet;3;3;;643;232;315;394;249;0;1;393;394
8;Barcelona;1;Barcelona;13;Barcelonès;08245;Santa Coloma de Gramenet;3;4;;779;234;313;400;379;4;1;395;396
8;Barcelona;1;Barcelona;13;Barcelonès;08245;Santa Coloma de Gramenet;3;5;;842;208;310;397;445;1;0;396;396
8;Barcelona;1;Barcelona;13;Barcelonès;08245;Santa Coloma de Gramenet;3;6;;870;259;357;454;416;0;1;453;454
8;Barcelona;1;Barcelona;13;Barcelonès;08245;Santa Coloma de Gramenet;3;7;;1341;494;653;832;509;3;9;820;829
8;Barcelona;1;Barcelona;13;Barcelonès;08245;Santa Coloma de Gramenet;3;8;;595;183;265;348;247;4;1;343;344
8;Barcelona;1;Barcelona;13;Barcelonès;08245;Santa Coloma de Gramenet;3;9;;1216;379;550;705;511;2;3;700;703
8;Barcelona;1;Barcelona;13;Barcelonès;08245;Santa Coloma de Gramenet;4;1;;840;271;393;516;324;0;3;513;516
8;Barcelona;1;Barcelona;13;Barcelonès;08245;Santa Coloma de Gramenet;4;10;;900;339;459;541;359;1;6;534;540
8;Barcelona;1;Barcelona;13;Barcelonès;08245;Santa Coloma de Gramenet;4;11;;787;277;390;477;310;6;2;469;471
8;Barcelona;1;Barcelona;13;Barcelonès;08245;Santa Coloma de Gramenet;4;12;;740;251;331;441;299;2;0;439;439
8;Barcelona;1;Barcelona;13;Barcelonès;08245;Santa Coloma de Gramenet;4;13;;795;303;394;481;314;1;2;478;480
8;Barcelona;1;Barcelona;13;Barcelonès;08245;Santa Coloma de Gramenet;4;14;;1307;439;613;789;518;0;2;787;789
8;Barcelona;1;Barcelona;13;Barcelonès;08245;Santa Coloma de Gramenet;4;15;;936;309;434;510;426;5;2;503;505
8;Barcelona;1;Barcelona;13;Barcelonès;08245;Santa Coloma de Gramenet;4;16;;1104;396;547;680;424;5;2;673;675
8;Barcelona;1;Barcelona;13;Barcelonès;08245;Santa Coloma de Gramenet;4;2;;941;387;514;650;291;5;1;644;645
8;Barcelona;1;Barcelona;13;Barcelonès;08245;Santa Coloma de Gramenet;4;3;;1265;449;638;795;470;7;4;784;788
8;Barcelona;1;Barcelona;13;Barcelonès;08245;Santa Coloma de Gramenet;4;4;;1174;424;595;793;381;3;8;782;790
8;Barcelona;1;Barcelona;13;Barcelonès;08245;Santa Coloma de Gramenet;4;5;;802;294;407;504;298;2;0;502;502
8;Barcelona;1;Barcelona;13;Barcelonès;08245;Santa Coloma de Gramenet;4;6;;963;368;459;600;363;5;2;593;595
8;Barcelona;1;Barcelona;13;Barcelonès;08245;Santa Coloma de Gramenet;4;7;;1160;443;567;716;444;0;5;711;716
8;Barcelona;1;Barcelona;13;Barcelonès;08245;Santa Coloma de Gramenet;4;8;;1248;389;602;780;468;4;2;774;776
8;Barcelona;1;Barcelona;13;Barcelonès;08245;Santa Coloma de Gramenet;4;9;;1143;411;558;709;434;1;2;706;708
8;Barcelona;1;Barcelona;13;Barcelonès;08245;Santa Coloma de Gramenet;5;1;;567;158;248;298;269;0;1;297;298
8;Barcelona;1;Barcelona;13;Barcelonès;08245;Santa Coloma de Gramenet;5;11;;1279;325;470;596;683;7;1;588;589
8;Barcelona;1;Barcelona;13;Barcelonès;08245;Santa Coloma de Gramenet;5;12;;769;187;278;357;412;1;0;356;356
8;Barcelona;1;Barcelona;13;Barcelonès;08245;Santa Coloma de Gramenet;5;13;;1336;362;486;594;742;4;2;588;590
8;Barcelona;1;Barcelona;13;Barcelonès;08245;Santa Coloma de Gramenet;5;14;;1026;287;397;512;514;3;5;504;509
8;Barcelona;1;Barcelona;13;Barcelonès;08245;Santa Coloma de Gramenet;5;15;;946;282;397;478;468;3;2;473;475
8;Barcelona;1;Barcelona;13;Barcelonès;08245;Santa Coloma de Gramenet;5;16;;836;255;363;494;342;0;1;493;494
8;Barcelona;1;Barcelona;13;Barcelonès;08245;Santa Coloma de Gramenet;5;18;;646;117;183;242;404;0;1;241;242
8;Barcelona;1;Barcelona;13;Barcelonès;08245;Santa Coloma de Gramenet;5;19;;824;244;350;425;399;1;2;422;424
8;Barcelona;1;Barcelona;13;Barcelonès;08245;Santa Coloma de Gramenet;5;2;;943;312;423;531;412;4;3;524;527
8;Barcelona;1;Barcelona;13;Barcelonès;08245;Santa Coloma de Gramenet;5;3;;725;261;339;426;299;0;0;426;426
8;Barcelona;1;Barcelona;13;Barcelonès;08245;Santa Coloma de Gramenet;5;4;;575;188;267;328;247;2;1;325;326
8;Barcelona;1;Barcelona;13;Barcelonès;08245;Santa Coloma de Gramenet;5;5;;772;219;254;360;412;3;2;355;357
8;Barcelona;1;Barcelona;13;Barcelonès;08245;Santa Coloma de Gramenet;5;6;;608;183;256;339;269;0;1;338;339
8;Barcelona;1;Barcelona;13;Barcelonès;08245;Santa Coloma de Gramenet;5;7;;671;230;326;384;287;0;1;383;384
8;Barcelona;1;Barcelona;13;Barcelonès;08245;Santa Coloma de Gramenet;5;8;;574;131;203;245;329;2;1;242;243
8;Barcelona;1;Barcelona;13;Barcelonès;08245;Santa Coloma de Gramenet;5;9;;741;212;280;352;389;3;1;348;349
8;Barcelona;1;Barcelona;13;Barcelonès;08245;Santa Coloma de Gramenet;6;11;;757;251;322;380;377;4;4;372;376
8;Barcelona;1;Barcelona;13;Barcelonès;08245;Santa Coloma de Gramenet;6;12;;962;323;413;499;463;0;0;499;499
8;Barcelona;1;Barcelona;13;Barcelonès;08245;Santa Coloma de Gramenet;6;14;;1053;315;416;496;557;3;3;490;493
8;Barcelona;1;Barcelona;13;Barcelonès;08245;Santa Coloma de Gramenet;6;2;;578;192;263;316;262;1;2;313;315
8;Barcelona;1;Barcelona;13;Barcelonès;08245;Santa Coloma de Gramenet;6;3;;1043;334;429;556;487;3;1;552;553
8;Barcelona;1;Barcelona;13;Barcelonès;08245;Santa Coloma de Gramenet;6;4;;598;195;271;335;263;0;0;335;335
8;Barcelona;1;Barcelona;13;Barcelonès;08245;Santa Coloma de Gramenet;6;5;;591;179;217;322;269;2;3;317;320
8;Barcelona;1;Barcelona;13;Barcelonès;08245;Santa Coloma de Gramenet;6;8;;1330;474;734;811;519;1;3;807;810
8;Barcelona;1;Barcelona;13;Barcelonès;08245;Santa Coloma de Gramenet;6;9;;819;235;312;377;442;8;1;368;369
43;Tarragona;6;Camp de Tarragona;16;Conca de Barberà;43139;Santa Coloma de Queralt;1;1;;1207;456;709;893;314;16;22;855;877
43;Tarragona;6;Camp de Tarragona;16;Conca de Barberà;43139;Santa Coloma de Queralt;2;1;;803;301;463;612;191;10;9;593;602
17;Girona;3;Girona;10;Baix Empordà;17181;Santa Cristina d'Aro;1;1;;1833;563;891;1222;611;17;7;1198;1205
17;Girona;3;Girona;10;Baix Empordà;17181;Santa Cristina d'Aro;1;2;;1898;619;951;1097;801;5;6;1086;1092
8;Barcelona;1;Barcelona;13;Barcelonès;08194;Sant Adrià de Besòs;1;1;;1164;396;579;716;448;3;7;706;713
8;Barcelona;1;Barcelona;13;Barcelonès;08194;Sant Adrià de Besòs;1;2;;1201;408;589;750;451;2;17;731;748
8;Barcelona;1;Barcelona;13;Barcelonès;08194;Sant Adrià de Besòs;1;3;;1411;475;643;790;621;8;11;771;782
8;Barcelona;1;Barcelona;13;Barcelonès;08194;Sant Adrià de Besòs;1;4;;1323;466;621;791;532;1;18;772;790
8;Barcelona;1;Barcelona;13;Barcelonès;08194;Sant Adrià de Besòs;1;5;;1494;495;728;896;598;6;9;881;890
8;Barcelona;1;Barcelona;13;Barcelonès;08194;Sant Adrià de Besòs;1;6;;971;365;458;605;366;3;6;596;602
8;Barcelona;1;Barcelona;13;Barcelonès;08194;Sant Adrià de Besòs;2;1;;1231;373;484;632;599;4;8;620;628
8;Barcelona;1;Barcelona;13;Barcelonès;08194;Sant Adrià de Besòs;2;2;;1265;366;489;606;659;4;3;599;602
8;Barcelona;1;Barcelona;13;Barcelonès;08194;Sant Adrià de Besòs;2;3;;1281;384;547;708;573;6;3;699;702
8;Barcelona;1;Barcelona;13;Barcelonès;08194;Sant Adrià de Besòs;2;4;;1415;467;710;889;526;3;12;874;886
8;Barcelona;1;Barcelona;13;Barcelonès;08194;Sant Adrià de Besòs;2;5;;1383;487;689;886;497;2;5;879;884
8;Barcelona;1;Barcelona;13;Barcelonès;08194;Sant Adrià de Besòs;3;1;;402;106;148;183;219;0;0;183;183
8;Barcelona;1;Barcelona;13;Barcelonès;08194;Sant Adrià de Besòs;4;1;;832;285;410;500;332;0;6;494;500
8;Barcelona;1;Barcelona;13;Barcelonès;08194;Sant Adrià de Besòs;5;1;;1121;388;539;684;437;9;5;670;675
8;Barcelona;1;Barcelona;13;Barcelonès;08194;Sant Adrià de Besòs;5;2;;1105;401;495;595;510;2;1;592;593
8;Barcelona;1;Barcelona;13;Barcelonès;08194;Sant Adrià de Besòs;5;3;;686;177;281;372;314;1;3;368;371
8;Barcelona;1;Barcelona;13;Barcelonès;08194;Sant Adrià de Besòs;5;4;;960;330;459;549;411;1;0;548;548
8;Barcelona;1;Barcelona;13;Barcelonès;08194;Sant Adrià de Besòs;6;1;;321;59;82;95;226;1;1;93;94
8;Barcelona;1;Barcelona;13;Barcelonès;08194;Sant Adrià de Besòs;6;2;;974;150;215;257;717;0;1;256;257
8;Barcelona;1;Barcelona;13;Barcelonès;08194;Sant Adrià de Besòs;6;3;;578;110;145;168;410;2;3;163;166
8;Barcelona;1;Barcelona;13;Barcelonès;08194;Sant Adrià de Besòs;6;4;;1132;185;241;307;825;10;0;297;297
8;Barcelona;1;Barcelona;13;Barcelonès;08194;Sant Adrià de Besòs;6;5;;910;243;346;411;499;4;3;404;407
8;Barcelona;1;Barcelona;13;Barcelonès;08194;Sant Adrià de Besòs;6;6;;1128;194;257;301;827;3;1;297;298
8;Barcelona;1;Barcelona;13;Barcelonès;08194;Sant Adrià de Besòs;6;7;;1543;447;599;744;799;7;12;725;737
8;Barcelona;2;Catalunya Central;24;Osona;08246;Santa Eugènia de Berga;1;1;;1678;709;1081;1315;363;8;31;1276;1307
8;Barcelona;2;Catalunya Central;24;Osona;08247;Santa Eulàlia de Riuprimer;1;1;;989;389;575;724;265;37;177;510;687
8;Barcelona;1;Barcelona;41;Vallès Oriental;08248;Santa Eulàlia de Ronçana;1;1;;2823;907;1374;1762;1061;12;16;1734;1750
8;Barcelona;1;Barcelona;41;Vallès Oriental;08248;Santa Eulàlia de Ronçana;1;2;;2817;936;1447;1782;1035;9;12;1761;1773
8;Barcelona;8;Penedès;3;Alt Penedès;08249;Santa Fe del Penedès;1;1;;275;144;212;260;15;4;8;248;256
8;Barcelona;2;Catalunya Central;24;Osona;08195;Sant Agustí de Lluçanès;1;1;;76;30;46;68;8;5;5;58;63
17;Girona;3;Girona;2;Alt Empordà;17182;Santa Llogaia d'Àlguema;1;1;;274;90;126;165;109;0;37;128;165
8;Barcelona;8;Penedès;6;Anoia;08250;Santa Margarida de Montbui;1;1;;666;282;426;524;142;5;4;515;519
8;Barcelona;8;Penedès;6;Anoia;08250;Santa Margarida de Montbui;1;2;;1617;610;873;1060;557;9;4;1047;1051
8;Barcelona;8;Penedès;6;Anoia;08250;Santa Margarida de Montbui;1;3;;871;288;472;582;289;2;6;574;580
8;Barcelona;8;Penedès;6;Anoia;08250;Santa Margarida de Montbui;1;4;;682;241;365;500;182;9;0;491;491
8;Barcelona;8;Penedès;6;Anoia;08250;Santa Margarida de Montbui;1;5;;1856;781;982;1218;638;4;6;1208;1214
8;Barcelona;8;Penedès;6;Anoia;08250;Santa Margarida de Montbui;1;6;;948;302;406;530;418;5;4;521;525
8;Barcelona;8;Penedès;6;Anoia;08250;Santa Margarida de Montbui;1;7;;566;223;288;355;211;3;0;352;352
8;Barcelona;8;Penedès;3;Alt Penedès;08251;Santa Margarida i els Monjos;1;1;;872;385;516;612;260;5;2;605;607
8;Barcelona;8;Penedès;3;Alt Penedès;08251;Santa Margarida i els Monjos;1;2;;1167;460;621;782;385;5;2;775;777
8;Barcelona;8;Penedès;3;Alt Penedès;08251;Santa Margarida i els Monjos;1;3;;1866;654;936;1162;704;8;13;1141;1154
8;Barcelona;8;Penedès;3;Alt Penedès;08251;Santa Margarida i els Monjos;1;4;;1255;500;653;832;423;5;6;821;827
8;Barcelona;2;Catalunya Central;42;Moianès;08258;Santa Maria d'Oló;1;1;;821;296;442;589;232;32;73;484;557
8;Barcelona;2;Catalunya Central;24;Osona;08253;Santa Maria de Besora;1;1;;128;65;88;104;24;0;10;94;104
8;Barcelona;1;Barcelona;41;Vallès Oriental;08256;Santa Maria de Martorelles;1;1;;696;283;405;511;185;4;7;500;507
8;Barcelona;2;Catalunya Central;14;Berguedà;08255;Santa Maria de Merlès;1;1;;136;36;58;91;45;5;26;60;86
8;Barcelona;8;Penedès;6;Anoia;08257;Santa Maria de Miralles;1;1;;106;43;60;83;23;3;5;75;80
8;Barcelona;1;Barcelona;41;Vallès Oriental;08259;Santa Maria de Palautordera;1;1;;2148;876;1185;1460;688;17;55;1388;1443
8;Barcelona;1;Barcelona;41;Vallès Oriental;08259;Santa Maria de Palautordera;1;2;;1738;639;898;1176;562;18;24;1134;1158
8;Barcelona;1;Barcelona;41;Vallès Oriental;08259;Santa Maria de Palautordera;1;3;;1816;627;1004;1272;544;19;42;1211;1253
8;Barcelona;1;Barcelona;41;Vallès Oriental;08259;Santa Maria de Palautordera;1;4;;1308;534;791;993;315;1;21;971;992
8;Barcelona;1;Barcelona;11;Baix Llobregat;08196;Sant Andreu de la Barca;1;1;;1479;495;682;879;600;9;4;866;870
8;Barcelona;1;Barcelona;11;Baix Llobregat;08196;Sant Andreu de la Barca;1;10;;1654;538;756;918;736;4;8;906;914
8;Barcelona;1;Barcelona;11;Baix Llobregat;08196;Sant Andreu de la Barca;1;11;;1480;532;744;934;546;5;5;924;929
8;Barcelona;1;Barcelona;11;Baix Llobregat;08196;Sant Andreu de la Barca;1;12;;1593;544;696;964;629;3;2;959;961
8;Barcelona;1;Barcelona;11;Baix Llobregat;08196;Sant Andreu de la Barca;1;13;;897;373;466;610;287;4;4;602;606
8;Barcelona;1;Barcelona;11;Baix Llobregat;08196;Sant Andreu de la Barca;1;14;;1997;698;989;1313;684;10;13;1290;1303
8;Barcelona;1;Barcelona;11;Baix Llobregat;08196;Sant Andreu de la Barca;1;2;;1464;431;610;826;638;8;5;813;818
8;Barcelona;1;Barcelona;11;Baix Llobregat;08196;Sant Andreu de la Barca;1;3;;1092;371;514;670;422;8;4;658;662
8;Barcelona;1;Barcelona;11;Baix Llobregat;08196;Sant Andreu de la Barca;1;4;;1247;441;625;783;464;9;6;768;774
8;Barcelona;1;Barcelona;11;Baix Llobregat;08196;Sant Andreu de la Barca;1;5;;1203;422;595;732;471;3;4;725;729
8;Barcelona;1;Barcelona;11;Baix Llobregat;08196;Sant Andreu de la Barca;1;6;;1206;410;568;726;480;5;4;717;721
8;Barcelona;1;Barcelona;11;Baix Llobregat;08196;Sant Andreu de la Barca;1;7;;1343;483;695;874;469;2;8;864;872
8;Barcelona;1;Barcelona;11;Baix Llobregat;08196;Sant Andreu de la Barca;1;8;;1075;372;529;717;358;4;5;708;713
8;Barcelona;1;Barcelona;11;Baix Llobregat;08196;Sant Andreu de la Barca;1;9;;1799;623;839;1081;718;5;6;1070;1076
8;Barcelona;1;Barcelona;21;Maresme;08197;Sant Andreu de Llavaneres;1;1;;1590;544;808;988;602;10;6;972;978
8;Barcelona;1;Barcelona;21;Maresme;08197;Sant Andreu de Llavaneres;1;2;;1684;608;885;1091;593;5;9;1077;1086
8;Barcelona;1;Barcelona;21;Maresme;08197;Sant Andreu de Llavaneres;1;3;;1272;487;712;866;406;2;7;857;864
8;Barcelona;1;Barcelona;21;Maresme;08197;Sant Andreu de Llavaneres;2;1;;1265;406;611;778;487;3;22;753;775
8;Barcelona;1;Barcelona;21;Maresme;08197;Sant Andreu de Llavaneres;2;2;;1322;422;623;772;550;1;7;764;771
8;Barcelona;1;Barcelona;21;Maresme;08197;Sant Andreu de Llavaneres;2;3;;893;294;420;591;302;4;5;582;587
17;Girona;3;Girona;20;Gironès;17157;Sant Andreu Salou;1;1;;124;37;81;110;14;0;6;104;110
17;Girona;3;Girona;19;Garrotxa;17183;Sant Aniol de Finestres;1;1;;261;130;185;228;33;4;3;221;224
8;Barcelona;1;Barcelona;41;Vallès Oriental;08198;Sant Antoni de Vilamajor;1;1;;1207;441;615;821;386;16;31;774;805
8;Barcelona;1;Barcelona;41;Vallès Oriental;08198;Sant Antoni de Vilamajor;1;2;;1219;372;531;688;531;6;11;671;682
8;Barcelona;1;Barcelona;41;Vallès Oriental;08198;Sant Antoni de Vilamajor;1;3;;1001;372;509;677;324;3;9;665;674
8;Barcelona;1;Barcelona;41;Vallès Oriental;08198;Sant Antoni de Vilamajor;1;4;;1251;505;698;868;383;11;23;834;857
43;Tarragona;8;Penedès;12;Baix Penedès;43140;Santa Oliva;1;1;;1076;472;684;825;251;9;6;810;816
43;Tarragona;8;Penedès;12;Baix Penedès;43140;Santa Oliva;1;2;;1372;493;622;850;522;9;6;835;841
17;Girona;3;Girona;19;Garrotxa;17184;Santa Pau;1;1;;1269;552;828;1030;239;12;29;989;1018
8;Barcelona;1;Barcelona;40;Vallès Occidental;08260;Santa Perpètua de Mogoda;1;1;;1234;385;539;686;548;2;1;683;684
8;Barcelona;1;Barcelona;40;Vallès Occidental;08260;Santa Perpètua de Mogoda;1;10;;755;290;453;515;240;4;10;501;511
8;Barcelona;1;Barcelona;40;Vallès Occidental;08260;Santa Perpètua de Mogoda;1;11;;954;311;421;500;454;5;2;493;495
8;Barcelona;1;Barcelona;40;Vallès Occidental;08260;Santa Perpètua de Mogoda;1;12;;1556;578;774;1000;556;8;3;989;992
8;Barcelona;1;Barcelona;40;Vallès Occidental;08260;Santa Perpètua de Mogoda;1;13;;848;239;407;599;249;2;1;596;597
8;Barcelona;1;Barcelona;40;Vallès Occidental;08260;Santa Perpètua de Mogoda;1;14;;764;270;394;523;241;3;8;512;520
8;Barcelona;1;Barcelona;40;Vallès Occidental;08260;Santa Perpètua de Mogoda;1;15;;1139;370;506;669;470;3;5;661;666
8;Barcelona;1;Barcelona;40;Vallès Occidental;08260;Santa Perpètua de Mogoda;1;16;;1324;388;583;843;481;2;4;837;841
8;Barcelona;1;Barcelona;40;Vallès Occidental;08260;Santa Perpètua de Mogoda;1;2;;936;346;462;561;375;0;0;561;561
8;Barcelona;1;Barcelona;40;Vallès Occidental;08260;Santa Perpètua de Mogoda;1;3;;1654;662;905;1107;547;5;14;1088;1102
8;Barcelona;1;Barcelona;40;Vallès Occidental;08260;Santa Perpètua de Mogoda;1;4;;1194;340;439;540;654;2;1;537;538
8;Barcelona;1;Barcelona;40;Vallès Occidental;08260;Santa Perpètua de Mogoda;1;5;;1014;356;481;590;424;4;3;583;586
8;Barcelona;1;Barcelona;40;Vallès Occidental;08260;Santa Perpètua de Mogoda;1;6;;746;238;339;423;323;10;0;413;413
8;Barcelona;1;Barcelona;40;Vallès Occidental;08260;Santa Perpètua de Mogoda;1;7;;985;304;443;577;408;1;4;572;576
8;Barcelona;1;Barcelona;40;Vallès Occidental;08260;Santa Perpètua de Mogoda;1;8;;1403;446;624;790;613;7;2;781;783
8;Barcelona;1;Barcelona;40;Vallès Occidental;08260;Santa Perpètua de Mogoda;1;9;;1973;652;950;1235;738;5;4;1226;1230
8;Barcelona;1;Barcelona;21;Maresme;08261;Santa Susanna;1;1;;1439;554;812;1024;415;7;13;1004;1017
8;Barcelona;1;Barcelona;21;Maresme;08261;Santa Susanna;1;2;;986;373;512;654;332;4;4;646;650
8;Barcelona;2;Catalunya Central;24;Osona;08199;Sant Bartomeu del Grau;1;1;;648;315;461;544;104;3;17;524;541
8;Barcelona;1;Barcelona;11;Baix Llobregat;08200;Sant Boi de Llobregat;1;1;;731;233;296;364;367;2;1;361;362
8;Barcelona;1;Barcelona;11;Baix Llobregat;08200;Sant Boi de Llobregat;1;2;;1169;415;550;666;503;1;5;660;665
8;Barcelona;1;Barcelona;11;Baix Llobregat;08200;Sant Boi de Llobregat;1;3;;793;295;391;454;339;0;2;452;454
8;Barcelona;1;Barcelona;11;Baix Llobregat;08200;Sant Boi de Llobregat;1;4;;1221;416;560;686;535;2;1;683;684
8;Barcelona;1;Barcelona;11;Baix Llobregat;08200;Sant Boi de Llobregat;1;5;;1906;587;587;1027;879;4;8;1015;1023
8;Barcelona;1;Barcelona;11;Baix Llobregat;08200;Sant Boi de Llobregat;1;6;;689;259;259;388;301;2;5;381;386
8;Barcelona;1;Barcelona;11;Baix Llobregat;08200;Sant Boi de Llobregat;1;7;;835;319;444;546;289;5;2;539;541
8;Barcelona;1;Barcelona;11;Baix Llobregat;08200;Sant Boi de Llobregat;2;1;;2024;588;884;1285;739;1;3;1281;1284
8;Barcelona;1;Barcelona;11;Baix Llobregat;08200;Sant Boi de Llobregat;2;10;;1721;583;816;1020;701;2;10;1008;1018
8;Barcelona;1;Barcelona;11;Baix Llobregat;08200;Sant Boi de Llobregat;2;11;;1351;510;750;912;439;3;2;907;909
8;Barcelona;1;Barcelona;11;Baix Llobregat;08200;Sant Boi de Llobregat;2;12;;1824;608;854;1044;780;4;6;1034;1040
8;Barcelona;1;Barcelona;11;Baix Llobregat;08200;Sant Boi de Llobregat;2;13;;1473;553;772;1021;452;1;7;1013;1020
8;Barcelona;1;Barcelona;11;Baix Llobregat;08200;Sant Boi de Llobregat;2;14;;1412;438;640;818;594;5;2;811;813
8;Barcelona;1;Barcelona;11;Baix Llobregat;08200;Sant Boi de Llobregat;2;15;;1380;442;607;784;596;4;5;775;780
8;Barcelona;1;Barcelona;11;Baix Llobregat;08200;Sant Boi de Llobregat;2;16;;1193;430;618;805;388;2;6;797;803
8;Barcelona;1;Barcelona;11;Baix Llobregat;08200;Sant Boi de Llobregat;2;17;;1169;414;609;773;396;5;3;765;768
8;Barcelona;1;Barcelona;11;Baix Llobregat;08200;Sant Boi de Llobregat;2;18;;1151;418;571;788;363;2;4;782;786
8;Barcelona;1;Barcelona;11;Baix Llobregat;08200;Sant Boi de Llobregat;2;19;;639;217;278;417;222;1;5;411;416
8;Barcelona;1;Barcelona;11;Baix Llobregat;08200;Sant Boi de Llobregat;2;2;;1395;385;580;740;655;4;4;732;736
8;Barcelona;1;Barcelona;11;Baix Llobregat;08200;Sant Boi de Llobregat;2;3;;1339;398;586;740;599;3;3;734;737
8;Barcelona;1;Barcelona;11;Baix Llobregat;08200;Sant Boi de Llobregat;2;4;;957;334;447;578;379;2;3;573;576
8;Barcelona;1;Barcelona;11;Baix Llobregat;08200;Sant Boi de Llobregat;2;5;;1042;364;503;630;412;4;5;621;626
8;Barcelona;1;Barcelona;11;Baix Llobregat;08200;Sant Boi de Llobregat;2;6;;1160;398;561;714;446;3;1;710;711
8;Barcelona;1;Barcelona;11;Baix Llobregat;08200;Sant Boi de Llobregat;2;7;;830;244;344;427;403;3;0;424;424
8;Barcelona;1;Barcelona;11;Baix Llobregat;08200;Sant Boi de Llobregat;2;8;;1140;424;599;754;386;3;7;744;751
8;Barcelona;1;Barcelona;11;Baix Llobregat;08200;Sant Boi de Llobregat;2;9;;1189;386;503;637;552;4;1;632;633
8;Barcelona;1;Barcelona;11;Baix Llobregat;08200;Sant Boi de Llobregat;3;1;;1350;495;703;892;458;1;2;889;891
8;Barcelona;1;Barcelona;11;Baix Llobregat;08200;Sant Boi de Llobregat;3;2;;1437;505;725;938;499;4;5;929;934
8;Barcelona;1;Barcelona;11;Baix Llobregat;08200;Sant Boi de Llobregat;3;3;;1530;498;721;926;604;1;2;923;925
8;Barcelona;1;Barcelona;11;Baix Llobregat;08200;Sant Boi de Llobregat;3;4;;716;241;350;466;250;4;6;456;462
8;Barcelona;1;Barcelona;11;Baix Llobregat;08200;Sant Boi de Llobregat;3;5;;1725;609;866;1080;645;6;2;1072;1074
8;Barcelona;1;Barcelona;11;Baix Llobregat;08200;Sant Boi de Llobregat;3;6;;1106;406;573;731;375;2;6;723;729
8;Barcelona;1;Barcelona;11;Baix Llobregat;08200;Sant Boi de Llobregat;3;7;;1550;552;768;993;557;3;1;989;990
8;Barcelona;1;Barcelona;11;Baix Llobregat;08200;Sant Boi de Llobregat;3;8;;590;204;281;375;215;0;1;374;375
8;Barcelona;1;Barcelona;11;Baix Llobregat;08200;Sant Boi de Llobregat;3;9;;914;315;429;534;380;0;2;532;534
8;Barcelona;1;Barcelona;11;Baix Llobregat;08200;Sant Boi de Llobregat;4;1;;1647;572;799;1041;606;10;4;1027;1031
8;Barcelona;1;Barcelona;11;Baix Llobregat;08200;Sant Boi de Llobregat;4;2;;1610;625;880;1068;542;7;5;1056;1061
8;Barcelona;1;Barcelona;11;Baix Llobregat;08200;Sant Boi de Llobregat;4;3;;998;411;444;637;361;4;2;631;633
8;Barcelona;1;Barcelona;11;Baix Llobregat;08200;Sant Boi de Llobregat;4;4;;1028;378;500;635;393;3;3;629;632
8;Barcelona;1;Barcelona;11;Baix Llobregat;08200;Sant Boi de Llobregat;4;5;;1330;473;639;798;532;2;4;792;796
8;Barcelona;1;Barcelona;11;Baix Llobregat;08200;Sant Boi de Llobregat;4;6;;1542;513;682;850;692;4;3;843;846
8;Barcelona;1;Barcelona;11;Baix Llobregat;08200;Sant Boi de Llobregat;4;7;;1508;542;758;933;575;4;6;923;929
8;Barcelona;1;Barcelona;11;Baix Llobregat;08200;Sant Boi de Llobregat;4;8;;1443;490;690;873;570;4;5;864;869
8;Barcelona;1;Barcelona;11;Baix Llobregat;08200;Sant Boi de Llobregat;4;9;;936;308;436;599;337;1;2;596;598
8;Barcelona;1;Barcelona;11;Baix Llobregat;08200;Sant Boi de Llobregat;5;1;;1467;380;558;748;719;4;6;738;744
8;Barcelona;1;Barcelona;11;Baix Llobregat;08200;Sant Boi de Llobregat;5;2;;1151;280;387;485;666;1;4;480;484
8;Barcelona;1;Barcelona;11;Baix Llobregat;08200;Sant Boi de Llobregat;5;3;;1156;307;454;573;583;3;0;570;570
8;Barcelona;1;Barcelona;11;Baix Llobregat;08200;Sant Boi de Llobregat;6;1;;1757;563;799;1059;698;1;10;1048;1058
8;Barcelona;1;Barcelona;11;Baix Llobregat;08200;Sant Boi de Llobregat;6;2;;1394;459;665;816;578;2;0;814;814
8;Barcelona;1;Barcelona;11;Baix Llobregat;08200;Sant Boi de Llobregat;6;3;;827;231;327;417;410;1;2;414;416
8;Barcelona;2;Catalunya Central;24;Osona;08201;Sant Boi de Lluçanès;1;1;;457;185;252;315;142;17;24;274;298
43;Tarragona;7;Terres de l'Ebre;22;Montsià;43136;Sant Carles de la Ràpita;1;1;;2005;750;1023;1269;736;18;24;1227;1251
43;Tarragona;7;Terres de l'Ebre;22;Montsià;43136;Sant Carles de la Ràpita;1;2;;1153;443;570;769;384;3;12;754;766
43;Tarragona;7;Terres de l'Ebre;22;Montsià;43136;Sant Carles de la Ràpita;1;3;;860;376;483;578;282;7;6;565;571
43;Tarragona;7;Terres de l'Ebre;22;Montsià;43136;Sant Carles de la Ràpita;1;4;;1480;602;806;983;497;27;9;947;956
43;Tarragona;7;Terres de l'Ebre;22;Montsià;43136;Sant Carles de la Ràpita;1;5;;1013;343;459;567;446;4;4;559;563
43;Tarragona;7;Terres de l'Ebre;22;Montsià;43136;Sant Carles de la Ràpita;2;1;;575;242;327;402;173;4;5;393;398
43;Tarragona;7;Terres de l'Ebre;22;Montsià;43136;Sant Carles de la Ràpita;2;2;;527;204;296;357;170;13;10;334;344
43;Tarragona;7;Terres de l'Ebre;22;Montsià;43136;Sant Carles de la Ràpita;2;3;;1032;380;480;598;434;12;5;581;586
43;Tarragona;7;Terres de l'Ebre;22;Montsià;43136;Sant Carles de la Ràpita;2;4;;807;337;445;549;258;15;14;520;534
43;Tarragona;7;Terres de l'Ebre;22;Montsià;43136;Sant Carles de la Ràpita;2;5;;1207;533;679;841;366;10;17;814;831
8;Barcelona;1;Barcelona;21;Maresme;08203;Sant Cebrià de Vallalta;1;1;;1377;534;759;939;438;15;7;917;924
8;Barcelona;1;Barcelona;21;Maresme;08203;Sant Cebrià de Vallalta;1;2;;1125;433;577;702;423;3;8;691;699
8;Barcelona;1;Barcelona;41;Vallès Oriental;08202;Sant Celoni;1;1;;1509;618;879;1072;437;5;20;1047;1067
8;Barcelona;1;Barcelona;41;Vallès Oriental;08202;Sant Celoni;1;2;;819;341;467;602;217;4;10;588;598
8;Barcelona;1;Barcelona;41;Vallès Oriental;08202;Sant Celoni;1;3;;1481;514;743;950;531;8;16;926;942
8;Barcelona;1;Barcelona;41;Vallès Oriental;08202;Sant Celoni;1;4;;557;191;276;324;233;4;4;316;320
8;Barcelona;1;Barcelona;41;Vallès Oriental;08202;Sant Celoni;1;5;;1881;658;984;1228;653;6;10;1212;1222
8;Barcelona;1;Barcelona;41;Vallès Oriental;08202;Sant Celoni;1;6;;1804;651;947;1176;628;8;14;1154;1168
8;Barcelona;1;Barcelona;41;Vallès Oriental;08202;Sant Celoni;1;7;;1198;422;601;746;452;8;1;737;738
8;Barcelona;1;Barcelona;41;Vallès Oriental;08202;Sant Celoni;1;8;;858;331;474;632;226;3;4;625;629
8;Barcelona;1;Barcelona;41;Vallès Oriental;08202;Sant Celoni;1;9;;1227;494;684;834;393;3;6;825;831
8;Barcelona;1;Barcelona;41;Vallès Oriental;08202;Sant Celoni;2;1;;1597;577;796;979;618;10;4;965;969
8;Barcelona;1;Barcelona;11;Baix Llobregat;08204;Sant Climent de Llobregat;1;1;;1678;542;853;1235;443;13;13;1209;1222
8;Barcelona;1;Barcelona;11;Baix Llobregat;08204;Sant Climent de Llobregat;1;2;;1465;504;733;980;485;3;12;965;977
17;Girona;3;Girona;2;Alt Empordà;17158;Sant Climent Sescebes;1;1;;478;200;272;343;135;14;4;325;329
8;Barcelona;1;Barcelona;40;Vallès Occidental;08205;Sant Cugat del Vallès;1;1;;1390;507;720;921;469;5;4;912;916
8;Barcelona;1;Barcelona;40;Vallès Occidental;08205;Sant Cugat del Vallès;1;10;;972;319;486;637;335;1;2;634;636
8;Barcelona;1;Barcelona;40;Vallès Occidental;08205;Sant Cugat del Vallès;1;11;;1330;483;703;907;423;1;12;894;906
8;Barcelona;1;Barcelona;40;Vallès Occidental;08205;Sant Cugat del Vallès;1;12;;1673;530;813;1202;471;1;7;1194;1201
8;Barcelona;1;Barcelona;40;Vallès Occidental;08205;Sant Cugat del Vallès;1;13;;1076;353;605;819;257;1;5;813;818
8;Barcelona;1;Barcelona;40;Vallès Occidental;08205;Sant Cugat del Vallès;1;14;;747;251;422;553;194;0;0;553;553
8;Barcelona;1;Barcelona;40;Vallès Occidental;08205;Sant Cugat del Vallès;1;15;;1636;585;911;1228;408;1;14;1213;1227
8;Barcelona;1;Barcelona;40;Vallès Occidental;08205;Sant Cugat del Vallès;1;16;;800;286;469;598;202;2;7;589;596
8;Barcelona;1;Barcelona;40;Vallès Occidental;08205;Sant Cugat del Vallès;1;17;;1853;599;895;1274;579;1;10;1263;1273
8;Barcelona;1;Barcelona;40;Vallès Occidental;08205;Sant Cugat del Vallès;1;18;;1175;384;562;761;414;0;6;755;761
8;Barcelona;1;Barcelona;40;Vallès Occidental;08205;Sant Cugat del Vallès;1;19;;822;288;449;607;215;1;8;598;606
8;Barcelona;1;Barcelona;40;Vallès Occidental;08205;Sant Cugat del Vallès;1;2;;1181;438;543;840;341;1;6;833;839
8;Barcelona;1;Barcelona;40;Vallès Occidental;08205;Sant Cugat del Vallès;1;20;;1016;363;538;718;298;1;4;713;717
8;Barcelona;1;Barcelona;40;Vallès Occidental;08205;Sant Cugat del Vallès;1;21;;703;260;365;485;218;1;1;483;484
8;Barcelona;1;Barcelona;40;Vallès Occidental;08205;Sant Cugat del Vallès;1;22;;976;360;498;662;314;0;8;654;662
8;Barcelona;1;Barcelona;40;Vallès Occidental;08205;Sant Cugat del Vallès;1;23;;1089;400;593;810;279;2;3;805;808
8;Barcelona;1;Barcelona;40;Vallès Occidental;08205;Sant Cugat del Vallès;1;3;;872;305;461;611;261;0;6;605;611
8;Barcelona;1;Barcelona;40;Vallès Occidental;08205;Sant Cugat del Vallès;1;4;;1498;589;866;1091;407;0;4;1087;1091
8;Barcelona;1;Barcelona;40;Vallès Occidental;08205;Sant Cugat del Vallès;1;5;;1215;411;624;856;359;1;7;848;855
8;Barcelona;1;Barcelona;40;Vallès Occidental;08205;Sant Cugat del Vallès;1;6;;1829;614;923;1204;625;2;10;1192;1202
8;Barcelona;1;Barcelona;40;Vallès Occidental;08205;Sant Cugat del Vallès;1;7;;743;286;376;487;256;2;2;483;485
8;Barcelona;1;Barcelona;40;Vallès Occidental;08205;Sant Cugat del Vallès;1;8;;1796;644;934;1202;594;6;8;1188;1196
8;Barcelona;1;Barcelona;40;Vallès Occidental;08205;Sant Cugat del Vallès;1;9;;1239;473;716;963;276;0;5;958;963
8;Barcelona;1;Barcelona;40;Vallès Occidental;08205;Sant Cugat del Vallès;2;1;;1115;367;590;827;288;0;9;818;827
8;Barcelona;1;Barcelona;40;Vallès Occidental;08205;Sant Cugat del Vallès;2;10;;1471;476;779;1090;381;1;8;1081;1089
8;Barcelona;1;Barcelona;40;Vallès Occidental;08205;Sant Cugat del Vallès;2;11;;990;286;477;679;311;2;2;675;677
8;Barcelona;1;Barcelona;40;Vallès Occidental;08205;Sant Cugat del Vallès;2;12;;1179;422;641;880;299;1;2;877;879
8;Barcelona;1;Barcelona;40;Vallès Occidental;08205;Sant Cugat del Vallès;2;2;;1372;517;744;966;406;0;7;959;966
8;Barcelona;1;Barcelona;40;Vallès Occidental;08205;Sant Cugat del Vallès;2;3;;1151;389;542;700;451;3;4;693;697
8;Barcelona;1;Barcelona;40;Vallès Occidental;08205;Sant Cugat del Vallès;2;4;;958;356;513;701;257;2;4;695;699
8;Barcelona;1;Barcelona;40;Vallès Occidental;08205;Sant Cugat del Vallès;2;5;;986;342;476;633;353;1;4;628;632
8;Barcelona;1;Barcelona;40;Vallès Occidental;08205;Sant Cugat del Vallès;2;6;;1224;479;671;913;311;2;4;907;911
8;Barcelona;1;Barcelona;40;Vallès Occidental;08205;Sant Cugat del Vallès;2;7;;1138;443;636;823;315;2;3;818;821
8;Barcelona;1;Barcelona;40;Vallès Occidental;08205;Sant Cugat del Vallès;2;8;;1236;424;673;920;316;1;8;911;919
8;Barcelona;1;Barcelona;40;Vallès Occidental;08205;Sant Cugat del Vallès;2;9;;1487;560;814;1125;362;0;12;1113;1125
8;Barcelona;1;Barcelona;40;Vallès Occidental;08205;Sant Cugat del Vallès;3;1;;1284;435;695;848;436;2;1;845;846
8;Barcelona;1;Barcelona;40;Vallès Occidental;08205;Sant Cugat del Vallès;3;2;;1638;556;878;1207;431;2;10;1195;1205
8;Barcelona;1;Barcelona;40;Vallès Occidental;08205;Sant Cugat del Vallès;3;3;;1599;490;756;1061;538;1;8;1052;1060
8;Barcelona;1;Barcelona;40;Vallès Occidental;08205;Sant Cugat del Vallès;3;4;;1483;533;802;1065;418;1;12;1052;1064
8;Barcelona;1;Barcelona;40;Vallès Occidental;08205;Sant Cugat del Vallès;4;1;;927;312;476;629;298;2;0;627;627
8;Barcelona;1;Barcelona;40;Vallès Occidental;08205;Sant Cugat del Vallès;4;2;;1051;347;508;715;336;1;3;711;714
8;Barcelona;1;Barcelona;40;Vallès Occidental;08205;Sant Cugat del Vallès;4;3;;1314;495;705;892;422;0;7;885;892
8;Barcelona;1;Barcelona;40;Vallès Occidental;08205;Sant Cugat del Vallès;5;1;;1296;437;714;990;306;2;5;983;988
8;Barcelona;1;Barcelona;40;Vallès Occidental;08205;Sant Cugat del Vallès;5;2;;1001;286;455;671;330;0;4;667;671
8;Barcelona;1;Barcelona;40;Vallès Occidental;08205;Sant Cugat del Vallès;5;3;;1576;580;865;1179;397;1;4;1174;1178
8;Barcelona;1;Barcelona;40;Vallès Occidental;08205;Sant Cugat del Vallès;5;4;;1542;477;784;1150;392;2;9;1139;1148
8;Barcelona;1;Barcelona;40;Vallès Occidental;08205;Sant Cugat del Vallès;5;5;;1044;364;546;745;299;4;8;733;741
8;Barcelona;1;Barcelona;40;Vallès Occidental;08205;Sant Cugat del Vallès;5;6;;1358;441;678;986;372;1;8;977;985
8;Barcelona;1;Barcelona;40;Vallès Occidental;08205;Sant Cugat del Vallès;5;7;;1645;553;890;1175;470;2;3;1170;1173
8;Barcelona;1;Barcelona;40;Vallès Occidental;08205;Sant Cugat del Vallès;5;8;;947;351;492;655;292;4;6;645;651
8;Barcelona;1;Barcelona;40;Vallès Occidental;08205;Sant Cugat del Vallès;6;1;;951;264;404;536;415;0;3;533;536
8;Barcelona;8;Penedès;3;Alt Penedès;08206;Sant Cugat Sesgarrigues;1;1;;739;323;517;629;110;3;8;618;626
25;Lleida;5;Alt Pirineu i territori d'Aran;25;Pallars Jussà;25196;Sant Esteve de la Sarga;1;1;;118;56;73;105;13;0;0;105;105
8;Barcelona;1;Barcelona;41;Vallès Oriental;08207;Sant Esteve de Palautordera;1;1;;2040;958;1316;1627;413;22;66;1539;1605
8;Barcelona;1;Barcelona;11;Baix Llobregat;08208;Sant Esteve Sesrovires;1;1;;1442;558;812;1017;425;6;14;997;1011
8;Barcelona;1;Barcelona;11;Baix Llobregat;08208;Sant Esteve Sesrovires;1;2;;1716;713;998;1284;432;4;24;1256;1280
8;Barcelona;1;Barcelona;11;Baix Llobregat;08208;Sant Esteve Sesrovires;1;3;;908;351;462;621;287;2;9;610;619
8;Barcelona;1;Barcelona;11;Baix Llobregat;08208;Sant Esteve Sesrovires;1;4;;1008;323;475;611;397;1;6;604;610
8;Barcelona;1;Barcelona;11;Baix Llobregat;08208;Sant Esteve Sesrovires;1;5;;745;197;275;358;387;3;3;352;355
17;Girona;3;Girona;34;Selva;17159;Sant Feliu de Buixalleu;1;1;;638;209;360;471;167;10;22;439;461
8;Barcelona;1;Barcelona;41;Vallès Oriental;08210;Sant Feliu de Codines;1;1;;1197;459;656;792;405;7;3;782;785
8;Barcelona;1;Barcelona;41;Vallès Oriental;08210;Sant Feliu de Codines;1;2;;1461;504;746;913;548;7;13;893;906
8;Barcelona;1;Barcelona;41;Vallès Oriental;08210;Sant Feliu de Codines;2;1;;1132;398;603;767;365;6;3;758;761
8;Barcelona;1;Barcelona;41;Vallès Oriental;08210;Sant Feliu de Codines;2;2;;831;343;469;551;280;4;4;543;547
17;Girona;3;Girona;10;Baix Empordà;17160;Sant Feliu de Guíxols;1;1;;1029;362;516;678;351;4;8;666;674
17;Girona;3;Girona;10;Baix Empordà;17160;Sant Feliu de Guíxols;1;2;;1447;543;793;1001;446;11;5;985;990
17;Girona;3;Girona;10;Baix Empordà;17160;Sant Feliu de Guíxols;2;1;;1042;462;587;707;335;3;6;698;704
17;Girona;3;Girona;10;Baix Empordà;17160;Sant Feliu de Guíxols;2;2;;1657;581;839;1023;634;8;13;1002;1015
17;Girona;3;Girona;10;Baix Empordà;17160;Sant Feliu de Guíxols;2;3;;1728;559;854;1034;694;3;2;1029;1031
17;Girona;3;Girona;10;Baix Empordà;17160;Sant Feliu de Guíxols;2;4;;845;243;400;476;369;2;4;470;474
17;Girona;3;Girona;10;Baix Empordà;17160;Sant Feliu de Guíxols;2;5;;1455;383;549;672;783;0;4;668;672
17;Girona;3;Girona;10;Baix Empordà;17160;Sant Feliu de Guíxols;3;1;;1673;674;895;1090;583;4;4;1082;1086
17;Girona;3;Girona;10;Baix Empordà;17160;Sant Feliu de Guíxols;3;2;;1069;343;540;676;393;2;8;666;674
17;Girona;3;Girona;10;Baix Empordà;17160;Sant Feliu de Guíxols;3;3;;940;293;452;570;370;3;3;564;567
17;Girona;3;Girona;10;Baix Empordà;17160;Sant Feliu de Guíxols;4;1;;1311;502;703;832;479;3;6;823;829
17;Girona;3;Girona;10;Baix Empordà;17160;Sant Feliu de Guíxols;4;2;;743;286;412;494;249;2;5;487;492
8;Barcelona;1;Barcelona;11;Baix Llobregat;08211;Sant Feliu de Llobregat;1;1;;1309;499;739;987;322;6;13;968;981
8;Barcelona;1;Barcelona;11;Baix Llobregat;08211;Sant Feliu de Llobregat;1;2;;1006;367;562;748;258;4;9;735;744
8;Barcelona;1;Barcelona;11;Baix Llobregat;08211;Sant Feliu de Llobregat;1;3;;1064;447;618;775;289;6;1;768;769
8;Barcelona;1;Barcelona;11;Baix Llobregat;08211;Sant Feliu de Llobregat;1;4;;1607;581;860;1153;454;5;15;1133;1148
8;Barcelona;1;Barcelona;11;Baix Llobregat;08211;Sant Feliu de Llobregat;1;5;;2042;737;1051;1394;648;2;11;1381;1392
8;Barcelona;1;Barcelona;11;Baix Llobregat;08211;Sant Feliu de Llobregat;1;6;;548;219;295;386;162;0;7;379;386
8;Barcelona;1;Barcelona;11;Baix Llobregat;08211;Sant Feliu de Llobregat;1;7;;1155;455;624;813;342;3;3;807;810
8;Barcelona;1;Barcelona;11;Baix Llobregat;08211;Sant Feliu de Llobregat;2;3;;1016;347;473;590;426;1;1;588;589
8;Barcelona;1;Barcelona;11;Baix Llobregat;08211;Sant Feliu de Llobregat;2;4;;1185;441;614;810;375;4;0;806;806
8;Barcelona;1;Barcelona;11;Baix Llobregat;08211;Sant Feliu de Llobregat;2;6;;1042;381;509;653;389;4;2;647;649
8;Barcelona;1;Barcelona;11;Baix Llobregat;08211;Sant Feliu de Llobregat;2;7;;834;292;410;541;293;0;3;538;541
8;Barcelona;1;Barcelona;11;Baix Llobregat;08211;Sant Feliu de Llobregat;2;8;;1266;465;630;828;438;6;3;819;822
8;Barcelona;1;Barcelona;11;Baix Llobregat;08211;Sant Feliu de Llobregat;3;1;;1279;407;619;779;500;5;4;770;774
8;Barcelona;1;Barcelona;11;Baix Llobregat;08211;Sant Feliu de Llobregat;3;2;;1480;512;732;966;514;2;9;955;964
8;Barcelona;1;Barcelona;11;Baix Llobregat;08211;Sant Feliu de Llobregat;3;3;;1346;516;744;954;392;1;9;944;953
8;Barcelona;1;Barcelona;11;Baix Llobregat;08211;Sant Feliu de Llobregat;3;4;;1496;626;852;1082;414;5;8;1069;1077
8;Barcelona;1;Barcelona;11;Baix Llobregat;08211;Sant Feliu de Llobregat;3;5;;1336;455;665;859;477;4;3;852;855
8;Barcelona;1;Barcelona;11;Baix Llobregat;08211;Sant Feliu de Llobregat;4;3;;804;285;392;485;319;3;1;481;482
8;Barcelona;1;Barcelona;11;Baix Llobregat;08211;Sant Feliu de Llobregat;4;6;;1342;412;576;732;610;5;6;721;727
8;Barcelona;1;Barcelona;11;Baix Llobregat;08211;Sant Feliu de Llobregat;4;7;;629;221;293;380;249;1;1;378;379
8;Barcelona;1;Barcelona;11;Baix Llobregat;08211;Sant Feliu de Llobregat;4;8;;649;220;309;400;249;2;1;397;398
8;Barcelona;1;Barcelona;11;Baix Llobregat;08211;Sant Feliu de Llobregat;5;1;;782;281;375;453;329;3;6;444;450
8;Barcelona;1;Barcelona;11;Baix Llobregat;08211;Sant Feliu de Llobregat;5;2;;669;251;323;392;277;4;1;387;388
8;Barcelona;1;Barcelona;11;Baix Llobregat;08211;Sant Feliu de Llobregat;5;3;;1076;342;496;624;452;4;9;611;620
8;Barcelona;1;Barcelona;11;Baix Llobregat;08211;Sant Feliu de Llobregat;5;4;;807;281;383;473;334;1;1;471;472
8;Barcelona;1;Barcelona;11;Baix Llobregat;08211;Sant Feliu de Llobregat;5;5;;1172;442;584;758;414;2;3;753;756
8;Barcelona;1;Barcelona;11;Baix Llobregat;08211;Sant Feliu de Llobregat;6;4;;1012;313;506;689;323;2;2;685;687
8;Barcelona;1;Barcelona;11;Baix Llobregat;08211;Sant Feliu de Llobregat;7;1;;1504;517;782;1062;442;4;10;1048;1058
8;Barcelona;1;Barcelona;11;Baix Llobregat;08211;Sant Feliu de Llobregat;7;2;;1616;575;887;1162;454;1;9;1152;1161
8;Barcelona;1;Barcelona;11;Baix Llobregat;08211;Sant Feliu de Llobregat;7;3;;891;247;376;557;334;2;7;548;555
17;Girona;3;Girona;19;Garrotxa;17161;Sant Feliu de Pallerols;1;1;;1029;520;740;885;144;8;21;856;877
8;Barcelona;2;Catalunya Central;7;Bages;08212;Sant Feliu Sasserra;1;1;;491;159;268;363;128;20;59;284;343
17;Girona;3;Girona;19;Garrotxa;17162;Sant Ferriol;1;1;;163;71;99;163;0;0;4;159;163
8;Barcelona;1;Barcelona;41;Vallès Oriental;08209;Sant Fost de Campsentelles;1;1;;1678;602;890;1099;579;7;14;1078;1092
8;Barcelona;1;Barcelona;41;Vallès Oriental;08209;Sant Fost de Campsentelles;1;2;;1406;469;659;876;530;2;6;868;874
8;Barcelona;1;Barcelona;41;Vallès Oriental;08209;Sant Fost de Campsentelles;1;3;;1938;740;1066;1340;598;5;4;1331;1335
8;Barcelona;1;Barcelona;41;Vallès Oriental;08209;Sant Fost de Campsentelles;1;4;;1904;581;813;1088;816;1;2;1085;1087
8;Barcelona;2;Catalunya Central;7;Bages;08213;Sant Fruitós de Bages;1;1;;938;385;516;663;275;8;17;638;655
8;Barcelona;2;Catalunya Central;7;Bages;08213;Sant Fruitós de Bages;1;2;;972;350;516;648;324;7;8;633;641
8;Barcelona;2;Catalunya Central;7;Bages;08213;Sant Fruitós de Bages;1;3;;1577;626;888;1131;446;14;13;1104;1117
8;Barcelona;2;Catalunya Central;7;Bages;08213;Sant Fruitós de Bages;1;4;;795;301;447;572;223;2;10;560;570
8;Barcelona;2;Catalunya Central;7;Bages;08213;Sant Fruitós de Bages;1;5;;1040;396;578;723;317;4;12;707;719
8;Barcelona;2;Catalunya Central;7;Bages;08213;Sant Fruitós de Bages;1;6;;1269;439;627;785;484;2;9;774;783
17;Girona;3;Girona;20;Gironès;17163;Sant Gregori;1;1;;1882;740;1136;1456;426;8;20;1428;1448
17;Girona;3;Girona;20;Gironès;17163;Sant Gregori;1;2;;977;416;633;720;257;0;12;708;720
25;Lleida;4;Lleida;32;Segarra;25192;Sant Guim de Freixenet;1;1;;723;291;429;555;168;16;24;515;539
25;Lleida;4;Lleida;32;Segarra;25197;Sant Guim de la Plana;1;1;;149;72;110;134;15;0;0;134;134
17;Girona;3;Girona;34;Selva;17164;Sant Hilari Sacalm;1;1;;1113;405;640;798;315;11;26;761;787
17;Girona;3;Girona;34;Selva;17164;Sant Hilari Sacalm;1;2;;1000;357;561;720;280;13;18;689;707
17;Girona;3;Girona;34;Selva;17164;Sant Hilari Sacalm;1;3;;1878;697;1100;1367;511;20;47;1300;1347
8;Barcelona;2;Catalunya Central;24;Osona;08215;Sant Hipòlit de Voltregà;1;1;;890;357;512;646;244;7;8;631;639
8;Barcelona;2;Catalunya Central;24;Osona;08215;Sant Hipòlit de Voltregà;1;2;;853;352;512;642;211;3;3;636;639
8;Barcelona;2;Catalunya Central;24;Osona;08215;Sant Hipòlit de Voltregà;1;3;;888;338;529;624;264;3;10;611;621
8;Barcelona;1;Barcelona;21;Maresme;08193;Sant Iscle de Vallalta;1;1;;996;422;588;738;258;5;13;720;733
43;Tarragona;7;Terres de l'Ebre;22;Montsià;43902;Sant Jaume d'Enveja;1;1;;1189;556;748;917;272;13;18;886;904
43;Tarragona;7;Terres de l'Ebre;22;Montsià;43902;Sant Jaume d'Enveja;1;2;;1581;692;950;1115;466;22;20;1073;1093
8;Barcelona;2;Catalunya Central;14;Berguedà;08216;Sant Jaume de Frontanyà;1;1;;26;9;10;21;5;0;0;21;21
17;Girona;3;Girona;19;Garrotxa;17165;Sant Jaume de Llierca;1;1;;643;146;388;464;179;37;71;356;427
43;Tarragona;8;Penedès;12;Baix Penedès;43137;Sant Jaume dels Domenys;1;1;;1918;790;1093;1337;581;13;33;1291;1324
17;Girona;3;Girona;31;Ripollès;17167;Sant Joan de les Abadesses;1;1;;571;320;403;459;112;11;9;439;448
17;Girona;3;Girona;31;Ripollès;17167;Sant Joan de les Abadesses;1;2;;1379;668;902;1102;277;13;27;1062;1089
17;Girona;3;Girona;31;Ripollès;17167;Sant Joan de les Abadesses;1;3;;651;317;443;540;111;4;9;527;536
17;Girona;3;Girona;20;Gironès;17168;Sant Joan de Mollet;1;1;;383;174;252;299;84;37;35;227;262
8;Barcelona;1;Barcelona;11;Baix Llobregat;08217;Sant Joan Despí;1;1;;1174;409;630;839;335;4;6;829;835
8;Barcelona;1;Barcelona;11;Baix Llobregat;08217;Sant Joan Despí;1;10;;1404;437;706;1013;391;4;6;1003;1009
8;Barcelona;1;Barcelona;11;Baix Llobregat;08217;Sant Joan Despí;1;2;;901;348;507;654;247;4;7;643;650
8;Barcelona;1;Barcelona;11;Baix Llobregat;08217;Sant Joan Despí;1;3;;1455;524;823;1063;392;3;5;1055;1060
8;Barcelona;1;Barcelona;11;Baix Llobregat;08217;Sant Joan Despí;1;4;;1952;620;966;1328;624;4;13;1311;1324
8;Barcelona;1;Barcelona;11;Baix Llobregat;08217;Sant Joan Despí;1;5;;1410;573;795;1028;382;1;8;1019;1027
8;Barcelona;1;Barcelona;11;Baix Llobregat;08217;Sant Joan Despí;1;6;;807;318;427;525;282;1;4;520;524
8;Barcelona;1;Barcelona;11;Baix Llobregat;08217;Sant Joan Despí;1;7;;1032;363;524;675;357;0;3;672;675
8;Barcelona;1;Barcelona;11;Baix Llobregat;08217;Sant Joan Despí;1;8;;1205;438;608;815;390;1;9;805;814
8;Barcelona;1;Barcelona;11;Baix Llobregat;08217;Sant Joan Despí;1;9;;1031;396;550;750;281;1;2;747;749
8;Barcelona;1;Barcelona;11;Baix Llobregat;08217;Sant Joan Despí;2;2;;1911;653;924;1242;669;2;5;1235;1240
8;Barcelona;1;Barcelona;11;Baix Llobregat;08217;Sant Joan Despí;2;3;;552;187;252;312;240;3;0;309;309
8;Barcelona;1;Barcelona;11;Baix Llobregat;08217;Sant Joan Despí;2;4;;923;328;422;514;409;0;5;509;514
8;Barcelona;1;Barcelona;11;Baix Llobregat;08217;Sant Joan Despí;3;1;;962;339;465;610;352;3;1;606;607
8;Barcelona;1;Barcelona;11;Baix Llobregat;08217;Sant Joan Despí;3;2;;1034;380;503;648;386;1;0;647;647
8;Barcelona;1;Barcelona;11;Baix Llobregat;08217;Sant Joan Despí;3;3;;631;245;315;403;228;2;1;400;401
8;Barcelona;1;Barcelona;11;Baix Llobregat;08217;Sant Joan Despí;3;4;;1284;491;645;815;469;0;4;811;815
8;Barcelona;1;Barcelona;11;Baix Llobregat;08217;Sant Joan Despí;3;5;;874;323;456;535;339;9;4;522;526
8;Barcelona;1;Barcelona;11;Baix Llobregat;08217;Sant Joan Despí;4;1;;2157;698;1128;1515;642;4;11;1500;1511
8;Barcelona;1;Barcelona;11;Baix Llobregat;08217;Sant Joan Despí;5;1;;2009;746;1056;1378;631;5;9;1364;1373
8;Barcelona;1;Barcelona;11;Baix Llobregat;08217;Sant Joan Despí;5;2;;894;318;479;667;227;0;8;659;667
8;Barcelona;2;Catalunya Central;7;Bages;08218;Sant Joan de Vilatorrada;1;1;;1652;691;949;1168;484;3;7;1158;1165
8;Barcelona;2;Catalunya Central;7;Bages;08218;Sant Joan de Vilatorrada;1;2;;1642;543;799;1085;557;4;4;1077;1081
8;Barcelona;2;Catalunya Central;7;Bages;08218;Sant Joan de Vilatorrada;1;3;;1682;638;896;1136;546;5;15;1116;1131
8;Barcelona;2;Catalunya Central;7;Bages;08218;Sant Joan de Vilatorrada;1;5;;1376;547;759;963;413;2;3;958;961
8;Barcelona;2;Catalunya Central;7;Bages;08218;Sant Joan de Vilatorrada;1;6;;1771;696;988;1219;552;3;8;1208;1216
17;Girona;3;Girona;19;Garrotxa;17185;Sant Joan les Fonts;1;1;;800;290;522;592;208;17;19;556;575
17;Girona;3;Girona;19;Garrotxa;17185;Sant Joan les Fonts;1;2;;600;192;343;424;176;10;13;401;414
17;Girona;3;Girona;19;Garrotxa;17185;Sant Joan les Fonts;1;3;;884;339;487;637;247;11;24;602;626
17;Girona;3;Girona;20;Gironès;17166;Sant Jordi Desvalls;1;1;;557;253;364;449;108;12;20;417;437
8;Barcelona;2;Catalunya Central;14;Berguedà;08903;Sant Julià de Cerdanyola;1;1;;198;105;138;165;33;6;14;145;159
17;Girona;3;Girona;34;Selva;17903;Sant Julià del Llor i Bonmatí;1;1;;901;352;478;604;297;31;55;518;573
17;Girona;3;Girona;20;Gironès;17169;Sant Julià de Ramis;1;1;;1902;676;1054;1345;557;16;38;1291;1329
17;Girona;3;Girona;20;Gironès;17169;Sant Julià de Ramis;1;2;;614;265;363;450;164;17;22;411;433
8;Barcelona;2;Catalunya Central;24;Osona;08220;Sant Julià de Vilatorta;1;1;;1255;499;753;962;293;79;191;692;883
8;Barcelona;2;Catalunya Central;24;Osona;08220;Sant Julià de Vilatorta;1;2;;1169;434;665;879;290;30;194;655;849
8;Barcelona;1;Barcelona;11;Baix Llobregat;08221;Sant Just Desvern;1;1;;1625;602;856;1150;475;2;9;1139;1148
8;Barcelona;1;Barcelona;11;Baix Llobregat;08221;Sant Just Desvern;1;2;;648;256;323;420;228;1;2;417;419
8;Barcelona;1;Barcelona;11;Baix Llobregat;08221;Sant Just Desvern;1;3;;1808;624;925;1221;587;6;11;1204;1215
8;Barcelona;1;Barcelona;11;Baix Llobregat;08221;Sant Just Desvern;1;4;;1335;568;758;954;381;7;7;940;947
8;Barcelona;1;Barcelona;11;Baix Llobregat;08221;Sant Just Desvern;1;5;;1494;507;751;1011;483;5;5;1001;1006
8;Barcelona;1;Barcelona;11;Baix Llobregat;08221;Sant Just Desvern;1;6;;2038;816;1148;1490;548;3;12;1475;1487
8;Barcelona;1;Barcelona;11;Baix Llobregat;08221;Sant Just Desvern;1;7;;1462;456;700;976;486;1;9;966;975
8;Barcelona;1;Barcelona;11;Baix Llobregat;08221;Sant Just Desvern;1;8;;1034;390;548;743;291;2;4;737;741
8;Barcelona;1;Barcelona;11;Baix Llobregat;08221;Sant Just Desvern;1;9;;1601;560;845;1139;462;3;14;1122;1136
8;Barcelona;8;Penedès;3;Alt Penedès;08222;Sant Llorenç d'Hortons;1;1;;1846;683;1043;1343;503;27;63;1253;1316
17;Girona;3;Girona;2;Alt Empordà;17171;Sant Llorenç de la Muga;1;1;;213;111;165;195;18;0;1;194;195
25;Lleida;2;Catalunya Central;35;Solsonès;25193;Sant Llorenç de Morunys;1;1;;776;341;458;575;201;18;36;521;557
8;Barcelona;1;Barcelona;40;Vallès Occidental;08223;Sant Llorenç Savall;1;1;;1895;681;986;1287;608;13;13;1261;1274
8;Barcelona;2;Catalunya Central;24;Osona;08225;Sant Martí d'Albars;1;1;;94;42;74;86;8;1;0;85;85
8;Barcelona;2;Catalunya Central;24;Osona;08224;Sant Martí de Centelles;1;1;;880;358;498;585;295;5;13;567;580
17;Girona;3;Girona;20;Gironès;17172;Sant Martí de Llémena;1;1;;469;176;273;345;124;4;17;324;341
25;Lleida;4;Lleida;38;Urgell;25902;Sant Martí de Riucorb;1;1;;546;252;364;466;80;6;13;447;460
8;Barcelona;8;Penedès;6;Anoia;08226;Sant Martí de Tous;1;1;;930;426;625;777;153;4;22;751;773
8;Barcelona;8;Penedès;3;Alt Penedès;08227;Sant Martí Sarroca;1;1;;1553;605;834;1077;476;11;11;1055;1066
8;Barcelona;8;Penedès;3;Alt Penedès;08227;Sant Martí Sarroca;1;2;;875;386;555;661;214;3;13;645;658
8;Barcelona;2;Catalunya Central;6;Anoia;08228;Sant Martí Sesgueioles;1;1;;291;115;185;251;40;1;4;246;250
17;Girona;3;Girona;20;Gironès;17173;Sant Martí Vell;1;1;;185;83;124;157;28;5;1;151;152
8;Barcelona;2;Catalunya Central;7;Bages;08229;Sant Mateu de Bages;1;1;;522;243;350;433;89;2;11;420;431
17;Girona;3;Girona;28;Pla de l'Estany;17174;Sant Miquel de Campmajor;1;1;;165;71;95;132;33;2;7;123;130
17;Girona;3;Girona;2;Alt Empordà;17175;Sant Miquel de Fluvià;1;1;;576;177;270;315;261;8;26;281;307
17;Girona;3;Girona;2;Alt Empordà;17176;Sant Mori;1;1;;131;72;94;109;22;0;4;105;109
17;Girona;3;Girona;31;Ripollès;17177;Sant Pau de Segúries;1;1;;572;282;414;469;103;2;18;449;467
8;Barcelona;2;Catalunya Central;7;Bages;08192;Santpedor;1;1;;1091;484;671;792;299;9;10;773;783
8;Barcelona;2;Catalunya Central;7;Bages;08192;Santpedor;1;2;;1929;743;1027;1298;631;12;14;1272;1286
8;Barcelona;2;Catalunya Central;7;Bages;08192;Santpedor;1;3;;1972;779;1089;1425;547;24;36;1365;1401
8;Barcelona;2;Catalunya Central;7;Bages;08192;Santpedor;1;4;;726;256;364;521;205;2;25;494;519
8;Barcelona;8;Penedès;17;Garraf;08231;Sant Pere de Ribes;1;1;;1185;461;639;787;398;1;8;778;786
8;Barcelona;8;Penedès;17;Garraf;08231;Sant Pere de Ribes;1;10;;1263;424;561;724;539;0;2;722;724
8;Barcelona;8;Penedès;17;Garraf;08231;Sant Pere de Ribes;1;11;;902;329;435;543;359;1;3;539;542
8;Barcelona;8;Penedès;17;Garraf;08231;Sant Pere de Ribes;1;12;;1018;283;422;565;453;3;4;558;562
8;Barcelona;8;Penedès;17;Garraf;08231;Sant Pere de Ribes;1;13;;1175;387;541;687;488;0;3;684;687
8;Barcelona;8;Penedès;17;Garraf;08231;Sant Pere de Ribes;1;14;;743;230;324;415;328;0;1;414;415
8;Barcelona;8;Penedès;17;Garraf;08231;Sant Pere de Ribes;1;15;;1455;491;694;902;553;3;3;896;899
8;Barcelona;8;Penedès;17;Garraf;08231;Sant Pere de Ribes;1;16;;1068;369;509;641;427;2;5;634;639
8;Barcelona;8;Penedès;17;Garraf;08231;Sant Pere de Ribes;1;17;;1314;399;598;784;530;0;2;782;784
8;Barcelona;8;Penedès;17;Garraf;08231;Sant Pere de Ribes;1;2;;1113;373;566;719;394;2;3;714;717
8;Barcelona;8;Penedès;17;Garraf;08231;Sant Pere de Ribes;1;3;;1508;555;801;1005;503;4;5;996;1001
8;Barcelona;8;Penedès;17;Garraf;08231;Sant Pere de Ribes;1;4;;1444;538;711;873;571;4;1;868;869
8;Barcelona;8;Penedès;17;Garraf;08231;Sant Pere de Ribes;1;5;;1629;578;804;990;639;0;5;985;990
8;Barcelona;8;Penedès;17;Garraf;08231;Sant Pere de Ribes;1;6;;1241;399;554;713;528;2;2;709;711
8;Barcelona;8;Penedès;17;Garraf;08231;Sant Pere de Ribes;1;7;;1494;520;692;872;622;3;1;868;869
8;Barcelona;8;Penedès;17;Garraf;08231;Sant Pere de Ribes;1;8;;1222;425;599;775;447;1;4;770;774
8;Barcelona;8;Penedès;17;Garraf;08231;Sant Pere de Ribes;1;9;;1790;562;873;1120;670;10;10;1100;1110
8;Barcelona;8;Penedès;3;Alt Penedès;08232;Sant Pere de Riudebitlles;1;1;;1797;706;1036;1288;509;35;54;1199;1253
8;Barcelona;2;Catalunya Central;24;Osona;08233;Sant Pere de Torelló;1;1;;734;308;448;566;168;16;53;497;550
8;Barcelona;2;Catalunya Central;24;Osona;08233;Sant Pere de Torelló;1;2;;1126;381;671;868;258;25;58;785;843
8;Barcelona;1;Barcelona;41;Vallès Oriental;08234;Sant Pere de Vilamajor;1;1;;916;371;537;672;244;9;29;634;663
8;Barcelona;1;Barcelona;41;Vallès Oriental;08234;Sant Pere de Vilamajor;1;2;;1045;382;535;635;410;14;35;586;621
8;Barcelona;1;Barcelona;41;Vallès Oriental;08234;Sant Pere de Vilamajor;1;3;;1457;516;743;900;557;4;39;857;896
17;Girona;3;Girona;2;Alt Empordà;17178;Sant Pere Pescador;1;1;;1090;489;646;757;333;6;23;728;751
8;Barcelona;2;Catalunya Central;6;Anoia;08189;Sant Pere Sallavinera;1;1;;122;45;77;102;20;2;7;93;100
8;Barcelona;1;Barcelona;21;Maresme;08235;Sant Pol de Mar;1;1;;1119;450;622;789;330;7;15;767;782
8;Barcelona;1;Barcelona;21;Maresme;08235;Sant Pol de Mar;1;2;;1708;712;1000;1277;431;12;26;1239;1265
8;Barcelona;1;Barcelona;21;Maresme;08235;Sant Pol de Mar;1;3;;1062;431;631;792;270;8;13;771;784
8;Barcelona;8;Penedès;3;Alt Penedès;08236;Sant Quintí de Mediona;1;1;;1571;673;930;1141;430;6;23;1112;1135
8;Barcelona;2;Catalunya Central;24;Osona;08237;Sant Quirze de Besora;1;1;;1021;433;622;757;264;14;12;731;743
8;Barcelona;2;Catalunya Central;24;Osona;08237;Sant Quirze de Besora;1;2;;646;291;419;510;136;7;12;491;503
8;Barcelona;1;Barcelona;40;Vallès Occidental;08238;Sant Quirze del Vallès;1;1;;1219;486;714;895;324;7;6;882;888
8;Barcelona;1;Barcelona;40;Vallès Occidental;08238;Sant Quirze del Vallès;1;10;;1038;392;536;684;354;5;4;675;679
8;Barcelona;1;Barcelona;40;Vallès Occidental;08238;Sant Quirze del Vallès;1;11;;1103;415;565;717;386;1;7;709;716
8;Barcelona;1;Barcelona;40;Vallès Occidental;08238;Sant Quirze del Vallès;1;12;;882;250;394;566;316;2;8;556;564
8;Barcelona;1;Barcelona;40;Vallès Occidental;08238;Sant Quirze del Vallès;1;2;;1003;410;608;773;230;3;4;766;770
8;Barcelona;1;Barcelona;40;Vallès Occidental;08238;Sant Quirze del Vallès;1;3;;1668;501;728;961;707;6;10;945;955
8;Barcelona;1;Barcelona;40;Vallès Occidental;08238;Sant Quirze del Vallès;1;4;;1407;568;862;1039;368;4;7;1028;1035
8;Barcelona;1;Barcelona;40;Vallès Occidental;08238;Sant Quirze del Vallès;1;5;;1589;538;813;1049;540;7;11;1031;1042
8;Barcelona;1;Barcelona;40;Vallès Occidental;08238;Sant Quirze del Vallès;1;6;;1288;450;654;897;391;4;6;887;893
8;Barcelona;1;Barcelona;40;Vallès Occidental;08238;Sant Quirze del Vallès;1;7;;1289;457;682;956;333;2;5;949;954
8;Barcelona;1;Barcelona;40;Vallès Occidental;08238;Sant Quirze del Vallès;1;8;;1676;607;869;1200;476;7;10;1183;1193
8;Barcelona;1;Barcelona;40;Vallès Occidental;08238;Sant Quirze del Vallès;1;9;;851;237;364;492;359;3;1;488;489
8;Barcelona;1;Barcelona;42;Moianès;08239;Sant Quirze Safaja;1;1;;468;185;261;343;125;6;12;325;337
25;Lleida;4;Lleida;32;Segarra;25194;Sant Ramon;1;1;;429;174;271;342;87;21;15;306;321
8;Barcelona;8;Penedès;3;Alt Penedès;08240;Sant Sadurní d'Anoia;1;1;;888;372;507;674;214;2;5;667;672
8;Barcelona;8;Penedès;3;Alt Penedès;08240;Sant Sadurní d'Anoia;1;2;;1507;604;831;1055;452;7;4;1044;1048
8;Barcelona;8;Penedès;3;Alt Penedès;08240;Sant Sadurní d'Anoia;1;3;;870;377;515;579;291;5;4;570;574
8;Barcelona;8;Penedès;3;Alt Penedès;08240;Sant Sadurní d'Anoia;1;4;;819;298;419;607;212;2;5;600;605
8;Barcelona;8;Penedès;3;Alt Penedès;08240;Sant Sadurní d'Anoia;2;1;;916;345;497;650;266;0;7;643;650
8;Barcelona;8;Penedès;3;Alt Penedès;08240;Sant Sadurní d'Anoia;2;2;;1564;609;811;1069;495;3;11;1055;1066
8;Barcelona;8;Penedès;3;Alt Penedès;08240;Sant Sadurní d'Anoia;2;3;;1095;378;576;782;313;11;7;764;771
8;Barcelona;8;Penedès;3;Alt Penedès;08240;Sant Sadurní d'Anoia;2;4;;1817;707;1056;1318;499;7;15;1296;1311
8;Barcelona;2;Catalunya Central;24;Osona;08241;Sant Sadurní d'Osormort;1;1;;69;30;40;55;14;0;2;53;55
8;Barcelona;2;Catalunya Central;7;Bages;08098;Sant Salvador de Guardiola;1;1;;1327;480;721;933;394;13;28;892;920
8;Barcelona;2;Catalunya Central;7;Bages;08098;Sant Salvador de Guardiola;1;2;;1098;421;563;691;407;3;21;667;688
8;Barcelona;2;Catalunya Central;7;Bages;08262;Sant Vicenç de Castellet;1;1;;1333;466;667;795;538;15;16;764;780
8;Barcelona;2;Catalunya Central;7;Bages;08262;Sant Vicenç de Castellet;1;2;;1222;410;500;773;449;5;9;759;768
8;Barcelona;2;Catalunya Central;7;Bages;08262;Sant Vicenç de Castellet;1;3;;1585;491;749;961;624;14;13;934;947
8;Barcelona;2;Catalunya Central;7;Bages;08262;Sant Vicenç de Castellet;2;1;;1823;604;862;1072;751;8;14;1050;1064
8;Barcelona;2;Catalunya Central;7;Bages;08262;Sant Vicenç de Castellet;2;2;;974;307;468;581;393;8;18;555;573
8;Barcelona;1;Barcelona;11;Baix Llobregat;08263;Sant Vicenç dels Horts;1;1;;659;260;412;500;159;5;2;493;495
8;Barcelona;1;Barcelona;11;Baix Llobregat;08263;Sant Vicenç dels Horts;1;10;;951;353;485;607;344;3;5;599;604
8;Barcelona;1;Barcelona;11;Baix Llobregat;08263;Sant Vicenç dels Horts;1;11;;1059;382;540;692;367;3;5;684;689
8;Barcelona;1;Barcelona;11;Baix Llobregat;08263;Sant Vicenç dels Horts;1;12;;634;228;314;382;252;1;5;376;381
8;Barcelona;1;Barcelona;11;Baix Llobregat;08263;Sant Vicenç dels Horts;1;2;;1424;563;812;1035;389;2;7;1026;1033
8;Barcelona;1;Barcelona;11;Baix Llobregat;08263;Sant Vicenç dels Horts;1;3;;1020;391;530;716;304;5;7;704;711
8;Barcelona;1;Barcelona;11;Baix Llobregat;08263;Sant Vicenç dels Horts;1;4;;1430;503;722;937;493;5;5;927;932
8;Barcelona;1;Barcelona;11;Baix Llobregat;08263;Sant Vicenç dels Horts;1;5;;1187;432;587;736;451;4;4;728;732
8;Barcelona;1;Barcelona;11;Baix Llobregat;08263;Sant Vicenç dels Horts;1;6;;666;254;345;418;248;3;2;413;415
8;Barcelona;1;Barcelona;11;Baix Llobregat;08263;Sant Vicenç dels Horts;1;7;;1297;436;635;811;486;10;8;793;801
8;Barcelona;1;Barcelona;11;Baix Llobregat;08263;Sant Vicenç dels Horts;1;8;;817;309;434;527;290;0;3;524;527
8;Barcelona;1;Barcelona;11;Baix Llobregat;08263;Sant Vicenç dels Horts;1;9;;579;191;276;363;216;1;1;361;362
8;Barcelona;1;Barcelona;11;Baix Llobregat;08263;Sant Vicenç dels Horts;2;1;;505;131;180;227;278;2;2;223;225
8;Barcelona;1;Barcelona;11;Baix Llobregat;08263;Sant Vicenç dels Horts;2;2;;1523;452;663;855;668;2;5;848;853
8;Barcelona;1;Barcelona;11;Baix Llobregat;08263;Sant Vicenç dels Horts;2;3;;995;263;365;489;506;3;4;482;486
8;Barcelona;1;Barcelona;11;Baix Llobregat;08263;Sant Vicenç dels Horts;3;1;;1422;455;600;765;657;8;11;746;757
8;Barcelona;1;Barcelona;11;Baix Llobregat;08263;Sant Vicenç dels Horts;3;2;;1376;427;589;753;623;3;6;744;750
8;Barcelona;1;Barcelona;11;Baix Llobregat;08263;Sant Vicenç dels Horts;4;1;;1397;422;614;848;549;9;9;830;839
8;Barcelona;1;Barcelona;11;Baix Llobregat;08263;Sant Vicenç dels Horts;4;2;;1391;391;594;755;636;1;6;748;754
8;Barcelona;1;Barcelona;11;Baix Llobregat;08263;Sant Vicenç dels Horts;4;3;;898;298;426;567;331;5;1;561;562
8;Barcelona;1;Barcelona;21;Maresme;08264;Sant Vicenç de Montalt;1;1;;1773;754;1043;1277;496;3;18;1256;1274
8;Barcelona;1;Barcelona;21;Maresme;08264;Sant Vicenç de Montalt;1;2;;1079;431;577;734;345;2;2;730;732
8;Barcelona;1;Barcelona;21;Maresme;08264;Sant Vicenç de Montalt;1;3;;753;270;429;564;189;1;4;559;563
8;Barcelona;1;Barcelona;21;Maresme;08264;Sant Vicenç de Montalt;1;4;;1012;310;459;626;386;3;3;620;623
8;Barcelona;2;Catalunya Central;24;Osona;08265;Sant Vicenç de Torelló;1;1;;1599;719;1021;1224;375;6;30;1188;1218
43;Tarragona;6;Camp de Tarragona;16;Conca de Barberà;43142;Sarral;1;1;;1089;505;718;849;240;8;12;829;841
17;Girona;3;Girona;20;Gironès;17186;Sarrià de Ter;1;1;;1051;448;592;763;288;9;6;748;754
17;Girona;3;Girona;20;Gironès;17186;Sarrià de Ter;1;2;;1702;614;929;1194;508;8;13;1173;1186
17;Girona;3;Girona;20;Gironès;17186;Sarrià de Ter;1;3;;1092;432;580;713;379;6;5;702;707
25;Lleida;5;Alt Pirineu i territori d'Aran;25;Pallars Jussà;25201;Sarroca de Bellera;1;1;;112;46;69;101;11;0;2;99;101
25;Lleida;4;Lleida;33;Segrià;25200;Sarroca de Lleida;1;1;;324;161;220;273;51;7;9;257;266
17;Girona;3;Girona;2;Alt Empordà;17187;Saus, Camallera i Llampaies;1;1;;636;278;395;499;137;5;13;481;494
43;Tarragona;6;Camp de Tarragona;16;Conca de Barberà;43143;Savallà del Comtat;1;1;;51;27;32;45;6;1;1;43;44
43;Tarragona;6;Camp de Tarragona;36;Tarragonès;43144;Secuita, la;1;1;;1247;487;638;841;406;33;71;737;808
43;Tarragona;6;Camp de Tarragona;8;Baix Camp;43145;Selva del Camp, la;1;1;;1922;765;1115;1415;507;17;20;1378;1398
43;Tarragona;6;Camp de Tarragona;8;Baix Camp;43145;Selva del Camp, la;2;1;;1262;483;729;929;333;6;18;905;923
43;Tarragona;6;Camp de Tarragona;8;Baix Camp;43145;Selva del Camp, la;2;2;;1050;419;629;827;223;12;6;809;815
17;Girona;3;Girona;2;Alt Empordà;17188;Selva de Mar, la;1;1;;176;79;108;141;35;4;5;132;137
43;Tarragona;6;Camp de Tarragona;16;Conca de Barberà;43146;Senan;1;1;;41;19;25;33;8;2;7;24;31
43;Tarragona;7;Terres de l'Ebre;22;Montsià;43044;Sénia, la;1;1;;1542;610;884;1088;454;20;31;1037;1068
43;Tarragona;7;Terres de l'Ebre;22;Montsià;43044;Sénia, la;2;1;;1645;635;916;1169;476;21;33;1115;1148
43;Tarragona;7;Terres de l'Ebre;22;Montsià;43044;Sénia, la;2;2;;878;340;485;597;281;17;19;561;580
25;Lleida;5;Alt Pirineu i territori d'Aran;25;Pallars Jussà;25202;Senterada;1;1;;115;44;56;84;31;1;1;82;83
25;Lleida;4;Lleida;23;Noguera;25035;Sentiu de Sió, la;1;1;;367;160;239;303;64;4;18;281;299
8;Barcelona;1;Barcelona;40;Vallès Occidental;08267;Sentmenat;1;1;;1212;384;591;774;438;4;7;763;770
8;Barcelona;1;Barcelona;40;Vallès Occidental;08267;Sentmenat;1;2;;1585;511;746;999;586;4;13;982;995
8;Barcelona;1;Barcelona;40;Vallès Occidental;08267;Sentmenat;1;3;;1243;391;640;845;398;3;3;839;842
8;Barcelona;1;Barcelona;40;Vallès Occidental;08267;Sentmenat;1;4;;1642;610;896;1152;490;8;14;1130;1144
8;Barcelona;1;Barcelona;40;Vallès Occidental;08267;Sentmenat;1;5;;1087;367;512;691;396;6;5;680;685
17;Girona;3;Girona;28;Pla de l'Estany;17190;Serinyà;1;1;;850;315;488;620;230;34;47;539;586
25;Lleida;4;Lleida;33;Segrià;25204;Seròs;1;1;;558;246;314;442;116;13;13;416;429
25;Lleida;4;Lleida;33;Segrià;25204;Seròs;1;2;;650;255;358;518;132;7;17;494;511
17;Girona;3;Girona;10;Baix Empordà;17191;Serra de Daró;1;1;;166;85;110;149;17;0;1;148;149
17;Girona;3;Girona;31;Ripollès;17192;Setcases;1;1;;148;75;110;132;16;2;1;129;130
25;Lleida;5;Alt Pirineu i territori d'Aran;4;Alt Urgell;25203;Seu d'Urgell, la;1;1;;549;194;260;319;230;2;5;312;317
25;Lleida;5;Alt Pirineu i territori d'Aran;4;Alt Urgell;25203;Seu d'Urgell, la;1;2;;1077;379;486;605;472;1;9;595;604
25;Lleida;5;Alt Pirineu i territori d'Aran;4;Alt Urgell;25203;Seu d'Urgell, la;1;3;;1373;472;653;860;513;7;12;841;853
25;Lleida;5;Alt Pirineu i territori d'Aran;4;Alt Urgell;25203;Seu d'Urgell, la;1;4;;1930;708;1049;1324;606;7;12;1305;1317
25;Lleida;5;Alt Pirineu i territori d'Aran;4;Alt Urgell;25203;Seu d'Urgell, la;1;5;;1292;457;593;768;524;2;6;760;766
25;Lleida;5;Alt Pirineu i territori d'Aran;4;Alt Urgell;25203;Seu d'Urgell, la;1;6;;1034;376;563;695;339;10;10;675;685
25;Lleida;5;Alt Pirineu i territori d'Aran;4;Alt Urgell;25203;Seu d'Urgell, la;1;7;;1627;601;840;1085;542;14;10;1061;1071
8;Barcelona;2;Catalunya Central;24;Osona;08269;Seva;1;1;;1732;715;1044;1261;471;13;42;1206;1248
8;Barcelona;2;Catalunya Central;24;Osona;08269;Seva;1;2;;993;422;613;770;223;15;37;718;755
25;Lleida;4;Lleida;27;Pla d'Urgell;25205;Sidamon;1;1;;566;241;336;424;142;9;9;406;415
17;Girona;3;Girona;34;Selva;17193;Sils;1;1;;1646;632;895;1094;552;12;17;1065;1082
17;Girona;3;Girona;34;Selva;17193;Sils;1;2;;1389;545;776;911;478;6;7;898;905
17;Girona;3;Girona;34;Selva;17193;Sils;1;3;;1334;395;552;667;667;4;6;657;663
8;Barcelona;8;Penedès;17;Garraf;08270;Sitges;1;1;;966;363;480;608;358;5;6;597;603
8;Barcelona;8;Penedès;17;Garraf;08270;Sitges;1;2;;1248;425;594;780;468;3;6;771;777
8;Barcelona;8;Penedès;17;Garraf;08270;Sitges;1;3;;2316;682;991;1384;932;5;8;1371;1379
8;Barcelona;8;Penedès;17;Garraf;08270;Sitges;1;4;;1908;653;946;1200;708;6;7;1187;1194
8;Barcelona;8;Penedès;17;Garraf;08270;Sitges;1;5;;653;219;317;400;253;2;2;396;398
8;Barcelona;8;Penedès;17;Garraf;08270;Sitges;2;1;;1568;642;873;1061;507;9;11;1041;1052
8;Barcelona;8;Penedès;17;Garraf;08270;Sitges;2;10;;1355;454;627;853;502;5;8;840;848
8;Barcelona;8;Penedès;17;Garraf;08270;Sitges;2;11;;1383;487;688;913;470;2;3;908;911
8;Barcelona;8;Penedès;17;Garraf;08270;Sitges;2;2;;1074;371;637;749;325;4;3;742;745
8;Barcelona;8;Penedès;17;Garraf;08270;Sitges;2;3;;1355;550;728;877;478;2;7;868;875
8;Barcelona;8;Penedès;17;Garraf;08270;Sitges;2;4;;1279;447;614;761;518;3;3;755;758
8;Barcelona;8;Penedès;17;Garraf;08270;Sitges;2;5;;946;353;490;595;351;4;6;585;591
8;Barcelona;8;Penedès;17;Garraf;08270;Sitges;2;6;;1251;461;645;875;376;5;16;854;870
8;Barcelona;8;Penedès;17;Garraf;08270;Sitges;2;7;;740;230;344;458;282;0;2;456;458
8;Barcelona;8;Penedès;17;Garraf;08270;Sitges;2;9;;1706;537;815;1086;620;2;10;1074;1084
17;Girona;3;Girona;2;Alt Empordà;17052;Siurana;1;1;;138;72;95;118;20;2;3;113;116
8;Barcelona;2;Catalunya Central;24;Osona;08271;Sobremunt;1;1;;68;25;33;51;17;2;1;48;49
25;Lleida;4;Lleida;18;Garrigues;25206;Soleràs, el;1;1;;254;107;158;205;49;2;8;195;203
43;Tarragona;6;Camp de Tarragona;16;Conca de Barberà;43147;Solivella;1;1;;522;259;343;405;117;21;55;329;384
25;Lleida;2;Catalunya Central;35;Solsonès;25207;Solsona;1;1;;1564;601;901;1149;415;3;9;1137;1146
25;Lleida;2;Catalunya Central;35;Solsonès;25207;Solsona;1;2;;1404;524;744;909;495;12;14;883;897
25;Lleida;2;Catalunya Central;35;Solsonès;25207;Solsona;1;3;;1018;404;571;703;315;4;18;681;699
25;Lleida;2;Catalunya Central;35;Solsonès;25207;Solsona;2;1;;1359;503;745;950;409;5;20;925;945
25;Lleida;2;Catalunya Central;35;Solsonès;25207;Solsona;2;2;;1125;427;615;762;363;9;14;739;753
8;Barcelona;2;Catalunya Central;24;Osona;08272;Sora;1;1;;165;62;95;123;42;1;13;109;122
25;Lleida;5;Alt Pirineu i territori d'Aran;26;Pallars Sobirà;25208;Soriguera;1;1;;339;116;165;275;64;7;3;265;268
25;Lleida;5;Alt Pirineu i territori d'Aran;26;Pallars Sobirà;25209;Sort;1;1;;1578;614;909;1234;344;15;25;1194;1219
25;Lleida;4;Lleida;33;Segrià;25210;Soses;1;1;;1089;530;735;893;196;32;21;840;861
8;Barcelona;8;Penedès;3;Alt Penedès;08273;Subirats;1;1;;657;290;411;514;143;5;12;497;509
8;Barcelona;8;Penedès;3;Alt Penedès;08273;Subirats;1;2;;1078;425;589;759;319;1;5;753;758
8;Barcelona;8;Penedès;3;Alt Penedès;08273;Subirats;1;3;;636;380;498;501;135;7;3;491;494
25;Lleida;4;Lleida;33;Segrià;25211;Sudanell;1;1;;672;288;408;512;160;3;9;500;509
25;Lleida;4;Lleida;33;Segrià;25212;Sunyer;1;1;;225;98;135;196;29;1;9;186;195
8;Barcelona;2;Catalunya Central;7;Bages;08274;Súria;1;1;;1485;628;907;1140;345;8;14;1118;1132
8;Barcelona;2;Catalunya Central;7;Bages;08274;Súria;1;2;;747;239;393;490;257;3;8;479;487
8;Barcelona;2;Catalunya Central;7;Bages;08274;Súria;1;4;;1483;502;795;999;484;1;10;988;998
8;Barcelona;2;Catalunya Central;7;Bages;08274;Súria;1;5;;960;433;621;729;231;6;4;719;723
17;Girona;3;Girona;34;Selva;17194;Susqueda;1;1;;83;27;39;65;18;1;6;58;64
8;Barcelona;1;Barcelona;41;Vallès Oriental;08276;Tagamanent;1;1;;240;78;115;149;91;8;29;112;141
8;Barcelona;2;Catalunya Central;7;Bages;08277;Talamanca;1;1;;179;87;130;163;16;1;1;161;162
25;Lleida;5;Alt Pirineu i territori d'Aran;25;Pallars Jussà;25215;Talarn;1;1;;399;134;194;252;147;3;15;234;249
25;Lleida;4;Lleida;32;Segarra;25216;Talavera;1;1;;242;124;162;214;28;1;2;211;213
17;Girona;3;Girona;10;Baix Empordà;17195;Tallada d'Empordà, la;1;1;;356;189;264;306;50;2;14;290;304
8;Barcelona;2;Catalunya Central;24;Osona;08278;Taradell;1;1;;1382;567;828;1044;338;12;45;987;1032
8;Barcelona;2;Catalunya Central;24;Osona;08278;Taradell;1;2;;1243;470;731;896;347;13;38;845;883
8;Barcelona;2;Catalunya Central;24;Osona;08278;Taradell;1;3;;952;366;586;721;231;11;31;679;710
8;Barcelona;2;Catalunya Central;24;Osona;08278;Taradell;1;4;;1352;554;844;1025;327;12;36;977;1013
43;Tarragona;6;Camp de Tarragona;36;Tarragonès;43148;Tarragona;1;1;;1009;337;482;605;404;3;5;597;602
43;Tarragona;6;Camp de Tarragona;36;Tarragonès;43148;Tarragona;2;1;;785;301;401;497;288;3;2;492;494
43;Tarragona;6;Camp de Tarragona;36;Tarragonès;43148;Tarragona;3;1;;767;329;407;510;257;6;3;501;504
43;Tarragona;6;Camp de Tarragona;36;Tarragonès;43148;Tarragona;3;2;;1383;635;799;1002;381;1;5;996;1001
43;Tarragona;6;Camp de Tarragona;36;Tarragonès;43148;Tarragona;3;3;;1704;631;908;1249;455;3;8;1238;1246
43;Tarragona;6;Camp de Tarragona;36;Tarragonès;43148;Tarragona;4;1;;1101;443;540;752;349;5;5;742;747
43;Tarragona;6;Camp de Tarragona;36;Tarragonès;43148;Tarragona;4;10;;874;352;469;557;317;2;1;554;555
43;Tarragona;6;Camp de Tarragona;36;Tarragonès;43148;Tarragona;4;12;;515;204;269;340;175;2;0;338;338
43;Tarragona;6;Camp de Tarragona;36;Tarragonès;43148;Tarragona;4;14;;1222;482;703;865;357;7;3;855;858
43;Tarragona;6;Camp de Tarragona;36;Tarragonès;43148;Tarragona;4;15;;707;294;389;493;214;1;4;488;492
43;Tarragona;6;Camp de Tarragona;36;Tarragonès;43148;Tarragona;4;16;;1362;587;808;1038;324;2;7;1029;1036
43;Tarragona;6;Camp de Tarragona;36;Tarragonès;43148;Tarragona;4;2;;579;220;288;389;190;4;4;381;385
43;Tarragona;6;Camp de Tarragona;36;Tarragonès;43148;Tarragona;4;3;;612;216;298;383;229;1;0;382;382
43;Tarragona;6;Camp de Tarragona;36;Tarragonès;43148;Tarragona;4;4;;863;339;457;593;270;0;7;586;593
43;Tarragona;6;Camp de Tarragona;36;Tarragonès;43148;Tarragona;4;5;;779;359;447;550;229;5;2;543;545
43;Tarragona;6;Camp de Tarragona;36;Tarragonès;43148;Tarragona;4;6;;1041;394;554;719;322;2;2;715;717
43;Tarragona;6;Camp de Tarragona;36;Tarragonès;43148;Tarragona;4;7;;649;244;375;461;188;1;2;458;460
43;Tarragona;6;Camp de Tarragona;36;Tarragonès;43148;Tarragona;4;8;;1143;536;629;764;379;0;2;762;764
43;Tarragona;6;Camp de Tarragona;36;Tarragonès;43148;Tarragona;4;9;;1352;509;783;1017;335;5;6;1006;1012
43;Tarragona;6;Camp de Tarragona;36;Tarragonès;43148;Tarragona;5;1;;759;323;435;532;227;0;3;529;532
43;Tarragona;6;Camp de Tarragona;36;Tarragonès;43148;Tarragona;5;2;;803;289;403;522;281;1;4;517;521
43;Tarragona;6;Camp de Tarragona;36;Tarragonès;43148;Tarragona;5;3;;1356;509;712;912;444;9;3;900;903
43;Tarragona;6;Camp de Tarragona;36;Tarragonès;43148;Tarragona;5;4;;918;355;473;621;297;1;2;618;620
43;Tarragona;6;Camp de Tarragona;36;Tarragonès;43148;Tarragona;5;5;;1185;441;575;715;470;2;2;711;713
43;Tarragona;6;Camp de Tarragona;36;Tarragonès;43148;Tarragona;5;6;;805;244;341;421;384;4;2;415;417
43;Tarragona;6;Camp de Tarragona;36;Tarragonès;43148;Tarragona;5;7;;723;274;283;448;275;1;0;447;447
43;Tarragona;6;Camp de Tarragona;36;Tarragonès;43148;Tarragona;5;8;;1177;474;624;763;414;7;3;753;756
43;Tarragona;6;Camp de Tarragona;36;Tarragonès;43148;Tarragona;6;1;;1242;525;712;913;329;2;6;905;911
43;Tarragona;6;Camp de Tarragona;36;Tarragonès;43148;Tarragona;6;10;;1124;419;562;750;374;1;1;748;749
43;Tarragona;6;Camp de Tarragona;36;Tarragonès;43148;Tarragona;6;11;;1085;455;585;700;385;5;1;694;695
43;Tarragona;6;Camp de Tarragona;36;Tarragonès;43148;Tarragona;6;12;;1374;606;804;993;381;1;2;990;992
43;Tarragona;6;Camp de Tarragona;36;Tarragonès;43148;Tarragona;6;13;;675;266;376;456;219;2;2;452;454
43;Tarragona;6;Camp de Tarragona;36;Tarragonès;43148;Tarragona;6;15;;901;285;395;472;429;1;3;468;471
43;Tarragona;6;Camp de Tarragona;36;Tarragonès;43148;Tarragona;6;16;;1927;821;1089;1393;534;2;5;1386;1391
43;Tarragona;6;Camp de Tarragona;36;Tarragonès;43148;Tarragona;6;2;;1900;749;931;1321;579;2;4;1315;1319
43;Tarragona;6;Camp de Tarragona;36;Tarragonès;43148;Tarragona;6;3;;1541;559;742;939;602;3;0;936;936
43;Tarragona;6;Camp de Tarragona;36;Tarragonès;43148;Tarragona;6;4;;659;233;292;368;291;0;3;365;368
43;Tarragona;6;Camp de Tarragona;36;Tarragonès;43148;Tarragona;6;5;;879;268;374;506;373;2;2;502;504
43;Tarragona;6;Camp de Tarragona;36;Tarragonès;43148;Tarragona;6;6;;567;200;246;284;283;0;2;282;284
43;Tarragona;6;Camp de Tarragona;36;Tarragonès;43148;Tarragona;6;8;;1241;397;678;840;401;3;1;836;837
43;Tarragona;6;Camp de Tarragona;36;Tarragonès;43148;Tarragona;6;9;;1527;614;847;1015;512;6;4;1005;1009
43;Tarragona;6;Camp de Tarragona;36;Tarragonès;43148;Tarragona;7;1;;1259;452;586;781;478;6;4;771;775
43;Tarragona;6;Camp de Tarragona;36;Tarragonès;43148;Tarragona;7;10;;981;294;376;476;505;4;5;467;472
43;Tarragona;6;Camp de Tarragona;36;Tarragonès;43148;Tarragona;7;11;;1393;537;683;833;560;1;5;827;832
43;Tarragona;6;Camp de Tarragona;36;Tarragonès;43148;Tarragona;7;12;;1148;339;478;607;541;5;2;600;602
43;Tarragona;6;Camp de Tarragona;36;Tarragonès;43148;Tarragona;7;13;;1966;726;1067;1393;573;2;4;1387;1391
43;Tarragona;6;Camp de Tarragona;36;Tarragonès;43148;Tarragona;7;14;;775;360;488;579;196;1;2;576;578
43;Tarragona;6;Camp de Tarragona;36;Tarragonès;43148;Tarragona;7;15;;1036;429;581;695;341;3;4;688;692
43;Tarragona;6;Camp de Tarragona;36;Tarragonès;43148;Tarragona;7;16;;1928;732;1015;1367;561;1;10;1356;1366
43;Tarragona;6;Camp de Tarragona;36;Tarragonès;43148;Tarragona;7;17;;1451;559;785;1037;414;0;5;1032;1037
43;Tarragona;6;Camp de Tarragona;36;Tarragonès;43148;Tarragona;7;18;;1346;438;603;815;531;6;2;807;809
43;Tarragona;6;Camp de Tarragona;36;Tarragonès;43148;Tarragona;7;19;;1751;640;839;1064;687;1;7;1056;1063
43;Tarragona;6;Camp de Tarragona;36;Tarragonès;43148;Tarragona;7;2;;1869;598;879;1214;655;7;7;1200;1207
43;Tarragona;6;Camp de Tarragona;36;Tarragonès;43148;Tarragona;7;20;;1070;346;564;778;292;0;4;774;778
43;Tarragona;6;Camp de Tarragona;36;Tarragonès;43148;Tarragona;7;21;;1422;420;646;861;561;4;5;852;857
43;Tarragona;6;Camp de Tarragona;36;Tarragonès;43148;Tarragona;7;22;;1080;359;520;698;382;1;4;693;697
43;Tarragona;6;Camp de Tarragona;36;Tarragonès;43148;Tarragona;7;23;;1112;399;596;837;275;1;6;830;836
43;Tarragona;6;Camp de Tarragona;36;Tarragonès;43148;Tarragona;7;3;;1385;446;583;754;631;3;2;749;751
43;Tarragona;6;Camp de Tarragona;36;Tarragonès;43148;Tarragona;7;4;;1910;668;943;1232;678;2;8;1222;1230
43;Tarragona;6;Camp de Tarragona;36;Tarragonès;43148;Tarragona;7;5;;600;150;175;256;344;2;2;252;254
43;Tarragona;6;Camp de Tarragona;36;Tarragonès;43148;Tarragona;7;6;;800;261;368;429;371;1;0;428;428
43;Tarragona;6;Camp de Tarragona;36;Tarragonès;43148;Tarragona;7;7;;1336;415;620;854;482;1;4;849;853
43;Tarragona;6;Camp de Tarragona;36;Tarragonès;43148;Tarragona;7;8;;2046;774;1115;1521;525;6;13;1502;1515
43;Tarragona;6;Camp de Tarragona;36;Tarragonès;43148;Tarragona;8;1;;1112;346;433;519;593;3;1;515;516
43;Tarragona;6;Camp de Tarragona;36;Tarragonès;43148;Tarragona;8;10;;801;205;257;309;492;3;3;303;306
43;Tarragona;6;Camp de Tarragona;36;Tarragonès;43148;Tarragona;8;11;;896;316;436;554;342;2;3;549;552
43;Tarragona;6;Camp de Tarragona;36;Tarragonès;43148;Tarragona;8;12;;526;68;114;138;388;0;0;138;138
43;Tarragona;6;Camp de Tarragona;36;Tarragonès;43148;Tarragona;8;13;;713;246;331;403;310;1;1;401;402
43;Tarragona;6;Camp de Tarragona;36;Tarragonès;43148;Tarragona;8;14;;541;144;195;251;290;4;0;247;247
43;Tarragona;6;Camp de Tarragona;36;Tarragonès;43148;Tarragona;8;2;;842;262;359;455;387;4;0;451;451
43;Tarragona;6;Camp de Tarragona;36;Tarragonès;43148;Tarragona;8;3;;1246;390;531;651;595;3;0;648;648
43;Tarragona;6;Camp de Tarragona;36;Tarragonès;43148;Tarragona;8;4;;787;267;347;425;362;0;0;425;425
43;Tarragona;6;Camp de Tarragona;36;Tarragonès;43148;Tarragona;8;5;;917;263;372;467;450;1;1;465;466
43;Tarragona;6;Camp de Tarragona;36;Tarragonès;43148;Tarragona;8;6;;1329;419;614;744;585;2;3;739;742
43;Tarragona;6;Camp de Tarragona;36;Tarragonès;43148;Tarragona;8;7;;1114;372;519;643;471;3;4;636;640
43;Tarragona;6;Camp de Tarragona;36;Tarragonès;43148;Tarragona;8;8;;912;267;363;441;471;4;1;436;437
43;Tarragona;6;Camp de Tarragona;36;Tarragonès;43148;Tarragona;8;9;;1912;564;799;1091;821;1;5;1085;1090
43;Tarragona;6;Camp de Tarragona;36;Tarragonès;43148;Tarragona;9;1;;1068;292;418;540;528;3;7;530;537
43;Tarragona;6;Camp de Tarragona;36;Tarragonès;43148;Tarragona;9;10;;971;285;367;462;509;4;7;451;458
43;Tarragona;6;Camp de Tarragona;36;Tarragonès;43148;Tarragona;9;2;;694;178;264;325;369;3;0;322;322
43;Tarragona;6;Camp de Tarragona;36;Tarragonès;43148;Tarragona;9;3;;684;199;269;339;345;1;2;336;338
43;Tarragona;6;Camp de Tarragona;36;Tarragonès;43148;Tarragona;9;4;;923;263;336;460;463;7;4;449;453
43;Tarragona;6;Camp de Tarragona;36;Tarragonès;43148;Tarragona;9;8;;599;177;225;289;310;2;2;285;287
43;Tarragona;6;Camp de Tarragona;36;Tarragonès;43148;Tarragona;9;9;;661;211;286;346;315;3;2;341;343
25;Lleida;4;Lleida;38;Urgell;25217;Tàrrega;1;1;;1656;581;801;1032;624;8;13;1011;1024
25;Lleida;4;Lleida;38;Urgell;25217;Tàrrega;1;2;;965;373;493;641;324;2;15;624;639
25;Lleida;4;Lleida;38;Urgell;25217;Tàrrega;2;1;;1189;422;642;813;376;5;8;800;808
25;Lleida;4;Lleida;38;Urgell;25217;Tàrrega;2;2;;1371;521;735;916;455;3;10;903;913
25;Lleida;4;Lleida;38;Urgell;25217;Tàrrega;2;3;;1207;419;616;805;402;1;15;789;804
25;Lleida;4;Lleida;38;Urgell;25217;Tàrrega;3;1;;1124;387;469;709;415;2;14;693;707
25;Lleida;4;Lleida;38;Urgell;25217;Tàrrega;3;2;;671;224;324;429;242;2;6;421;427
25;Lleida;4;Lleida;38;Urgell;25217;Tàrrega;3;3;;1101;391;560;719;382;3;8;708;716
25;Lleida;4;Lleida;38;Urgell;25217;Tàrrega;4;1;;563;206;284;361;202;4;11;346;357
25;Lleida;4;Lleida;38;Urgell;25217;Tàrrega;4;2;;1116;416;573;713;403;7;17;689;706
25;Lleida;4;Lleida;18;Garrigues;25218;Tarrés;1;1;;89;45;71;81;8;4;3;74;77
25;Lleida;4;Lleida;32;Segarra;25219;Tarroja de Segarra;1;1;;151;73;105;122;29;0;1;121;122
8;Barcelona;2;Catalunya Central;24;Osona;08275;Tavèrnoles;1;1;;247;128;183;231;16;8;12;211;223
8;Barcelona;2;Catalunya Central;24;Osona;08280;Tavertet;1;1;;97;49;73;84;13;2;0;82;82
8;Barcelona;1;Barcelona;21;Maresme;08281;Teià;1;1;;1650;697;967;1242;408;5;30;1207;1237
8;Barcelona;1;Barcelona;21;Maresme;08281;Teià;1;2;;1816;639;955;1189;627;7;25;1157;1182
8;Barcelona;1;Barcelona;21;Maresme;08281;Teià;1;3;;1439;550;814;1027;412;6;17;1004;1021
25;Lleida;4;Lleida;23;Noguera;25220;Térmens;1;1;;1039;505;754;891;148;14;21;856;877
17;Girona;3;Girona;2;Alt Empordà;17196;Terrades;1;1;;267;81;130;170;97;4;62;104;166
8;Barcelona;1;Barcelona;40;Vallès Occidental;08279;Terrassa;1;1;;1096;483;691;842;254;1;2;839;841
8;Barcelona;1;Barcelona;40;Vallès Occidental;08279;Terrassa;1;10;;981;340;513;693;288;0;3;690;693
8;Barcelona;1;Barcelona;40;Vallès Occidental;08279;Terrassa;1;11;;923;321;457;590;333;2;5;583;588
8;Barcelona;1;Barcelona;40;Vallès Occidental;08279;Terrassa;1;12;;1100;407;563;692;408;2;5;685;690
8;Barcelona;1;Barcelona;40;Vallès Occidental;08279;Terrassa;1;13;;643;216;308;390;253;2;6;382;388
8;Barcelona;1;Barcelona;40;Vallès Occidental;08279;Terrassa;1;14;;1625;545;754;946;679;4;1;941;942
8;Barcelona;1;Barcelona;40;Vallès Occidental;08279;Terrassa;1;15;;936;332;452;601;335;0;6;595;601
8;Barcelona;1;Barcelona;40;Vallès Occidental;08279;Terrassa;1;16;;1864;675;965;1245;619;4;2;1239;1241
8;Barcelona;1;Barcelona;40;Vallès Occidental;08279;Terrassa;1;17;;1657;653;944;1193;464;2;2;1189;1191
8;Barcelona;1;Barcelona;40;Vallès Occidental;08279;Terrassa;1;18;;440;182;264;342;98;1;2;339;341
8;Barcelona;1;Barcelona;40;Vallès Occidental;08279;Terrassa;1;19;;1158;408;578;735;423;2;7;726;733
8;Barcelona;1;Barcelona;40;Vallès Occidental;08279;Terrassa;1;2;;1117;448;596;791;326;0;5;786;791
8;Barcelona;1;Barcelona;40;Vallès Occidental;08279;Terrassa;1;20;;1049;414;578;800;249;2;3;795;798
8;Barcelona;1;Barcelona;40;Vallès Occidental;08279;Terrassa;1;21;;1070;359;519;696;374;1;4;691;695
8;Barcelona;1;Barcelona;40;Vallès Occidental;08279;Terrassa;1;22;;1405;488;712;982;423;1;6;975;981
8;Barcelona;1;Barcelona;40;Vallès Occidental;08279;Terrassa;1;23;;968;379;591;756;212;1;4;751;755
8;Barcelona;1;Barcelona;40;Vallès Occidental;08279;Terrassa;1;24;;663;276;384;493;170;0;4;489;493
8;Barcelona;1;Barcelona;40;Vallès Occidental;08279;Terrassa;1;4;;1539;595;819;1131;408;6;4;1121;1125
8;Barcelona;1;Barcelona;40;Vallès Occidental;08279;Terrassa;1;5;;987;392;563;764;223;2;3;759;762
8;Barcelona;1;Barcelona;40;Vallès Occidental;08279;Terrassa;1;6;;1212;487;673;899;313;0;3;896;899
8;Barcelona;1;Barcelona;40;Vallès Occidental;08279;Terrassa;1;7;;1428;486;710;1000;428;0;6;994;1000
8;Barcelona;1;Barcelona;40;Vallès Occidental;08279;Terrassa;1;8;;1983;769;1123;1467;516;1;7;1459;1466
8;Barcelona;1;Barcelona;40;Vallès Occidental;08279;Terrassa;1;9;;1050;382;546;746;304;3;2;741;743
8;Barcelona;1;Barcelona;40;Vallès Occidental;08279;Terrassa;2;1;;1094;351;474;612;482;2;1;609;610
8;Barcelona;1;Barcelona;40;Vallès Occidental;08279;Terrassa;2;11;;827;230;325;420;407;2;2;416;418
8;Barcelona;1;Barcelona;40;Vallès Occidental;08279;Terrassa;2;12;;673;171;241;307;366;4;2;301;303
8;Barcelona;1;Barcelona;40;Vallès Occidental;08279;Terrassa;2;14;;1477;379;541;793;684;3;2;788;790
8;Barcelona;1;Barcelona;40;Vallès Occidental;08279;Terrassa;2;15;;595;115;170;222;373;0;0;222;222
8;Barcelona;1;Barcelona;40;Vallès Occidental;08279;Terrassa;2;16;;1573;387;641;888;685;3;0;885;885
8;Barcelona;1;Barcelona;40;Vallès Occidental;08279;Terrassa;2;17;;1367;353;501;686;681;3;4;679;683
8;Barcelona;1;Barcelona;40;Vallès Occidental;08279;Terrassa;2;2;;458;102;143;187;271;1;0;186;186
8;Barcelona;1;Barcelona;40;Vallès Occidental;08279;Terrassa;2;3;;799;228;320;381;418;0;1;380;381
8;Barcelona;1;Barcelona;40;Vallès Occidental;08279;Terrassa;2;4;;660;200;261;319;341;0;3;316;319
8;Barcelona;1;Barcelona;40;Vallès Occidental;08279;Terrassa;2;5;;827;271;365;468;359;2;4;462;466
8;Barcelona;1;Barcelona;40;Vallès Occidental;08279;Terrassa;2;6;;737;200;308;399;338;1;0;398;398
8;Barcelona;1;Barcelona;40;Vallès Occidental;08279;Terrassa;2;8;;781;240;330;450;331;3;1;446;447
8;Barcelona;1;Barcelona;40;Vallès Occidental;08279;Terrassa;2;9;;1121;354;469;570;551;0;0;570;570
8;Barcelona;1;Barcelona;40;Vallès Occidental;08279;Terrassa;3;1;;1316;439;620;786;530;1;3;782;785
8;Barcelona;1;Barcelona;40;Vallès Occidental;08279;Terrassa;3;14;;1090;271;393;518;572;2;3;513;516
8;Barcelona;1;Barcelona;40;Vallès Occidental;08279;Terrassa;3;15;;918;334;459;558;360;0;0;558;558
8;Barcelona;1;Barcelona;40;Vallès Occidental;08279;Terrassa;3;16;;679;231;299;375;304;0;0;375;375
8;Barcelona;1;Barcelona;40;Vallès Occidental;08279;Terrassa;3;17;;840;292;381;452;388;3;1;448;449
8;Barcelona;1;Barcelona;40;Vallès Occidental;08279;Terrassa;3;18;;757;259;355;445;312;0;1;444;445
8;Barcelona;1;Barcelona;40;Vallès Occidental;08279;Terrassa;3;19;;906;295;395;487;419;1;1;485;486
8;Barcelona;1;Barcelona;40;Vallès Occidental;08279;Terrassa;3;2;;1107;406;590;746;361;1;5;740;745
8;Barcelona;1;Barcelona;40;Vallès Occidental;08279;Terrassa;3;20;;1181;411;552;654;527;1;5;648;653
8;Barcelona;1;Barcelona;40;Vallès Occidental;08279;Terrassa;3;3;;1222;403;561;695;527;1;6;688;694
8;Barcelona;1;Barcelona;40;Vallès Occidental;08279;Terrassa;3;4;;941;249;360;475;466;3;4;468;472
8;Barcelona;1;Barcelona;40;Vallès Occidental;08279;Terrassa;3;5;;1747;569;824;1077;670;3;7;1067;1074
8;Barcelona;1;Barcelona;40;Vallès Occidental;08279;Terrassa;3;6;;1527;534;780;1020;507;1;7;1012;1019
8;Barcelona;1;Barcelona;40;Vallès Occidental;08279;Terrassa;3;7;;1632;534;789;1061;571;1;4;1056;1060
8;Barcelona;1;Barcelona;40;Vallès Occidental;08279;Terrassa;3;8;;1553;462;674;835;718;3;1;831;832
8;Barcelona;1;Barcelona;40;Vallès Occidental;08279;Terrassa;4;1;;1102;435;614;767;335;0;4;763;767
8;Barcelona;1;Barcelona;40;Vallès Occidental;08279;Terrassa;4;10;;728;204;303;368;360;0;0;368;368
8;Barcelona;1;Barcelona;40;Vallès Occidental;08279;Terrassa;4;12;;1029;364;506;664;365;1;3;660;663
8;Barcelona;1;Barcelona;40;Vallès Occidental;08279;Terrassa;4;13;;1180;435;672;820;360;1;5;814;819
8;Barcelona;1;Barcelona;40;Vallès Occidental;08279;Terrassa;4;14;;994;398;600;770;224;0;1;769;770
8;Barcelona;1;Barcelona;40;Vallès Occidental;08279;Terrassa;4;15;;870;305;477;636;234;0;3;633;636
8;Barcelona;1;Barcelona;40;Vallès Occidental;08279;Terrassa;4;16;;976;365;568;722;254;1;5;716;721
8;Barcelona;1;Barcelona;40;Vallès Occidental;08279;Terrassa;4;17;;1171;464;698;875;296;0;3;872;875
8;Barcelona;1;Barcelona;40;Vallès Occidental;08279;Terrassa;4;18;;1934;716;1017;1320;614;3;6;1311;1317
8;Barcelona;1;Barcelona;40;Vallès Occidental;08279;Terrassa;4;19;;942;309;450;564;378;4;1;559;560
8;Barcelona;1;Barcelona;40;Vallès Occidental;08279;Terrassa;4;2;;1156;485;659;814;342;1;2;811;813
8;Barcelona;1;Barcelona;40;Vallès Occidental;08279;Terrassa;4;20;;535;152;215;267;268;1;0;266;266
8;Barcelona;1;Barcelona;40;Vallès Occidental;08279;Terrassa;4;21;;792;245;346;429;363;5;5;419;424
8;Barcelona;1;Barcelona;40;Vallès Occidental;08279;Terrassa;4;22;;1646;472;720;994;652;5;2;987;989
8;Barcelona;1;Barcelona;40;Vallès Occidental;08279;Terrassa;4;23;;1650;461;733;1006;644;3;2;1001;1003
8;Barcelona;1;Barcelona;40;Vallès Occidental;08279;Terrassa;4;24;;1578;424;652;851;727;0;4;847;851
8;Barcelona;1;Barcelona;40;Vallès Occidental;08279;Terrassa;4;25;;882;302;457;551;331;3;2;546;548
8;Barcelona;1;Barcelona;40;Vallès Occidental;08279;Terrassa;4;26;;1084;385;586;762;322;0;2;760;762
8;Barcelona;1;Barcelona;40;Vallès Occidental;08279;Terrassa;4;3;;1303;454;648;843;460;4;1;838;839
8;Barcelona;1;Barcelona;40;Vallès Occidental;08279;Terrassa;4;4;;1153;386;555;735;418;4;3;728;731
8;Barcelona;1;Barcelona;40;Vallès Occidental;08279;Terrassa;4;5;;1214;353;553;700;514;2;1;697;698
8;Barcelona;1;Barcelona;40;Vallès Occidental;08279;Terrassa;4;6;;1453;462;702;892;561;3;1;888;889
8;Barcelona;1;Barcelona;40;Vallès Occidental;08279;Terrassa;4;7;;1870;516;738;966;904;8;4;954;958
8;Barcelona;1;Barcelona;40;Vallès Occidental;08279;Terrassa;4;8;;961;301;455;588;373;3;3;582;585
8;Barcelona;1;Barcelona;40;Vallès Occidental;08279;Terrassa;4;9;;731;240;320;406;325;1;6;399;405
8;Barcelona;1;Barcelona;40;Vallès Occidental;08279;Terrassa;5;1;;1527;528;761;1004;523;5;7;992;999
8;Barcelona;1;Barcelona;40;Vallès Occidental;08279;Terrassa;5;10;;1411;509;685;825;586;3;4;818;822
8;Barcelona;1;Barcelona;40;Vallès Occidental;08279;Terrassa;5;11;;1449;523;753;975;474;0;0;975;975
8;Barcelona;1;Barcelona;40;Vallès Occidental;08279;Terrassa;5;12;;584;188;286;370;214;0;0;370;370
8;Barcelona;1;Barcelona;40;Vallès Occidental;08279;Terrassa;5;13;;1164;305;460;631;533;1;0;630;630
8;Barcelona;1;Barcelona;40;Vallès Occidental;08279;Terrassa;5;14;;1578;531;755;1015;563;2;7;1006;1013
8;Barcelona;1;Barcelona;40;Vallès Occidental;08279;Terrassa;5;15;;1508;457;640;801;707;2;3;796;799
8;Barcelona;1;Barcelona;40;Vallès Occidental;08279;Terrassa;5;16;;1894;564;788;1023;871;3;10;1010;1020
8;Barcelona;1;Barcelona;40;Vallès Occidental;08279;Terrassa;5;17;;1327;435;669;882;445;1;4;877;881
8;Barcelona;1;Barcelona;40;Vallès Occidental;08279;Terrassa;5;18;;996;393;540;668;328;1;2;665;667
8;Barcelona;1;Barcelona;40;Vallès Occidental;08279;Terrassa;5;19;;916;267;396;545;371;1;1;543;544
8;Barcelona;1;Barcelona;40;Vallès Occidental;08279;Terrassa;5;2;;1101;396;534;674;427;1;0;673;673
8;Barcelona;1;Barcelona;40;Vallès Occidental;08279;Terrassa;5;20;;1190;407;589;799;391;0;4;795;799
8;Barcelona;1;Barcelona;40;Vallès Occidental;08279;Terrassa;5;21;;1399;455;663;900;499;4;4;892;896
8;Barcelona;1;Barcelona;40;Vallès Occidental;08279;Terrassa;5;22;;566;200;271;349;217;0;0;349;349
8;Barcelona;1;Barcelona;40;Vallès Occidental;08279;Terrassa;5;23;;1270;460;638;841;429;0;3;838;841
8;Barcelona;1;Barcelona;40;Vallès Occidental;08279;Terrassa;5;24;;1192;431;581;773;419;0;5;768;773
8;Barcelona;1;Barcelona;40;Vallès Occidental;08279;Terrassa;5;25;;909;263;431;561;348;1;2;558;560
8;Barcelona;1;Barcelona;40;Vallès Occidental;08279;Terrassa;5;26;;1000;375;494;691;309;1;1;689;690
8;Barcelona;1;Barcelona;40;Vallès Occidental;08279;Terrassa;5;27;;927;299;485;660;267;0;8;652;660
8;Barcelona;1;Barcelona;40;Vallès Occidental;08279;Terrassa;5;28;;899;297;455;633;266;1;1;631;632
8;Barcelona;1;Barcelona;40;Vallès Occidental;08279;Terrassa;5;29;;905;270;434;630;275;1;9;620;629
8;Barcelona;1;Barcelona;40;Vallès Occidental;08279;Terrassa;5;3;;1488;641;773;943;545;0;1;942;943
8;Barcelona;1;Barcelona;40;Vallès Occidental;08279;Terrassa;5;4;;1226;341;641;835;391;0;2;833;835
8;Barcelona;1;Barcelona;40;Vallès Occidental;08279;Terrassa;5;5;;747;293;386;478;269;0;1;477;478
8;Barcelona;1;Barcelona;40;Vallès Occidental;08279;Terrassa;5;6;;1571;615;832;1074;497;0;3;1071;1074
8;Barcelona;1;Barcelona;40;Vallès Occidental;08279;Terrassa;5;7;;873;335;497;643;230;0;4;639;643
8;Barcelona;1;Barcelona;40;Vallès Occidental;08279;Terrassa;5;8;;1403;513;742;962;441;0;6;956;962
8;Barcelona;1;Barcelona;40;Vallès Occidental;08279;Terrassa;5;9;;1378;542;723;962;416;1;2;959;961
8;Barcelona;1;Barcelona;40;Vallès Occidental;08279;Terrassa;6;1;;900;319;466;561;339;1;0;560;560
8;Barcelona;1;Barcelona;40;Vallès Occidental;08279;Terrassa;6;10;;1629;491;760;1002;627;1;8;993;1001
8;Barcelona;1;Barcelona;40;Vallès Occidental;08279;Terrassa;6;11;;1258;372;507;649;609;1;2;646;648
8;Barcelona;1;Barcelona;40;Vallès Occidental;08279;Terrassa;6;12;;944;298;425;530;414;3;2;525;527
8;Barcelona;1;Barcelona;40;Vallès Occidental;08279;Terrassa;6;13;;695;233;333;396;299;2;3;391;394
8;Barcelona;1;Barcelona;40;Vallès Occidental;08279;Terrassa;6;14;;724;192;270;334;390;0;3;331;334
8;Barcelona;1;Barcelona;40;Vallès Occidental;08279;Terrassa;6;16;;1143;357;463;596;547;2;1;593;594
8;Barcelona;1;Barcelona;40;Vallès Occidental;08279;Terrassa;6;18;;892;287;415;504;388;1;2;501;503
8;Barcelona;1;Barcelona;40;Vallès Occidental;08279;Terrassa;6;2;;1188;393;499;656;532;1;5;650;655
8;Barcelona;1;Barcelona;40;Vallès Occidental;08279;Terrassa;6;20;;1110;259;388;498;612;3;1;494;495
8;Barcelona;1;Barcelona;40;Vallès Occidental;08279;Terrassa;6;23;;993;304;422;545;448;5;3;537;540
8;Barcelona;1;Barcelona;40;Vallès Occidental;08279;Terrassa;6;24;;1780;613;935;1010;770;2;2;1006;1008
8;Barcelona;1;Barcelona;40;Vallès Occidental;08279;Terrassa;6;25;;1447;433;633;819;628;3;4;812;816
8;Barcelona;1;Barcelona;40;Vallès Occidental;08279;Terrassa;6;26;;1184;369;475;677;507;1;3;673;676
8;Barcelona;1;Barcelona;40;Vallès Occidental;08279;Terrassa;6;27;;966;270;385;486;480;1;4;481;485
8;Barcelona;1;Barcelona;40;Vallès Occidental;08279;Terrassa;6;28;;1204;413;563;700;504;4;3;693;696
8;Barcelona;1;Barcelona;40;Vallès Occidental;08279;Terrassa;6;29;;816;232;337;453;363;2;1;450;451
8;Barcelona;1;Barcelona;40;Vallès Occidental;08279;Terrassa;6;3;;1491;452;640;827;664;1;3;823;826
8;Barcelona;1;Barcelona;40;Vallès Occidental;08279;Terrassa;6;30;;542;137;221;294;248;3;1;290;291
8;Barcelona;1;Barcelona;40;Vallès Occidental;08279;Terrassa;6;31;;731;201;287;368;363;2;0;366;366
8;Barcelona;1;Barcelona;40;Vallès Occidental;08279;Terrassa;6;32;;591;181;245;319;272;1;0;318;318
8;Barcelona;1;Barcelona;40;Vallès Occidental;08279;Terrassa;6;33;;1022;286;468;630;392;3;2;625;627
8;Barcelona;1;Barcelona;40;Vallès Occidental;08279;Terrassa;6;4;;893;252;354;455;438;1;1;453;454
8;Barcelona;1;Barcelona;40;Vallès Occidental;08279;Terrassa;6;5;;1087;316;452;607;480;4;2;601;603
8;Barcelona;1;Barcelona;40;Vallès Occidental;08279;Terrassa;6;6;;1156;294;422;590;566;2;6;582;588
8;Barcelona;1;Barcelona;40;Vallès Occidental;08279;Terrassa;6;8;;1672;540;764;1003;669;3;7;993;1000
8;Barcelona;1;Barcelona;40;Vallès Occidental;08279;Terrassa;6;9;;936;269;415;567;369;0;4;563;567
8;Barcelona;1;Barcelona;40;Vallès Occidental;08279;Terrassa;7;1;;2018;639;970;1253;765;1;2;1250;1252
8;Barcelona;1;Barcelona;40;Vallès Occidental;08279;Terrassa;7;2;;1512;448;582;797;715;2;0;795;795
8;Barcelona;1;Barcelona;40;Vallès Occidental;08279;Terrassa;7;3;;1140;237;362;471;669;1;6;464;470
8;Barcelona;1;Barcelona;40;Vallès Occidental;08279;Terrassa;7;4;;1828;550;794;1022;806;3;5;1014;1019
8;Barcelona;1;Barcelona;21;Maresme;08282;Tiana;1;1;;1841;708;985;1301;540;4;8;1289;1297
8;Barcelona;1;Barcelona;21;Maresme;08282;Tiana;1;2;;1690;621;923;1187;503;3;8;1176;1184
8;Barcelona;1;Barcelona;21;Maresme;08282;Tiana;1;3;;964;354;514;663;301;2;6;655;661
8;Barcelona;1;Barcelona;21;Maresme;08282;Tiana;1;4;;1337;470;699;949;388;0;9;940;949
8;Barcelona;1;Barcelona;21;Maresme;08282;Tiana;1;5;;947;329;488;655;292;1;11;643;654
25;Lleida;5;Alt Pirineu i territori d'Aran;26;Pallars Sobirà;25221;Tírvia;1;1;;117;32;50;81;36;7;9;65;74
25;Lleida;4;Lleida;23;Noguera;25222;Tiurana;1;1;;65;30;49;63;2;1;2;60;62
43;Tarragona;7;Terres de l'Ebre;9;Baix Ebre;43149;Tivenys;1;1;;715;392;545;630;85;9;11;610;621
43;Tarragona;7;Terres de l'Ebre;30;Ribera d'Ebre;43150;Tivissa;1;1;;1265;572;849;1068;197;30;27;1011;1038
8;Barcelona;2;Catalunya Central;24;Osona;08283;Tona;1;1;;1728;617;966;1185;543;7;17;1161;1178
8;Barcelona;2;Catalunya Central;24;Osona;08283;Tona;1;2;;1433;522;788;1022;411;2;16;1004;1020
8;Barcelona;2;Catalunya Central;24;Osona;08283;Tona;1;3;;1729;610;967;1240;489;10;24;1206;1230
8;Barcelona;2;Catalunya Central;24;Osona;08283;Tona;1;4;;1249;416;630;812;437;7;22;783;805
25;Lleida;4;Lleida;32;Segarra;25223;Torà;1;1;;914;396;595;718;196;16;29;673;702
8;Barcelona;1;Barcelona;21;Maresme;08284;Tordera;1;1;;1652;574;825;1033;619;9;6;1018;1024
8;Barcelona;1;Barcelona;21;Maresme;08284;Tordera;1;2;;1248;354;557;731;517;5;10;716;726
8;Barcelona;1;Barcelona;21;Maresme;08284;Tordera;1;3;;1534;415;639;869;665;9;11;849;860
8;Barcelona;1;Barcelona;21;Maresme;08284;Tordera;1;4;;1867;587;882;1140;727;16;13;1111;1124
8;Barcelona;1;Barcelona;21;Maresme;08284;Tordera;2;1;;2054;621;929;1151;903;5;10;1136;1146
8;Barcelona;1;Barcelona;21;Maresme;08284;Tordera;2;2;;2297;666;1044;1254;1043;5;7;1242;1249
8;Barcelona;1;Barcelona;21;Maresme;08284;Tordera;2;3;;1970;599;804;1048;922;8;9;1031;1040
8;Barcelona;2;Catalunya Central;24;Osona;08285;Torelló;1;1;;697;252;380;459;238;1;3;455;458
8;Barcelona;2;Catalunya Central;24;Osona;08285;Torelló;1;2;;1579;543;811;1043;536;5;13;1025;1038
8;Barcelona;2;Catalunya Central;24;Osona;08285;Torelló;1;4;;1584;533;804;1043;541;3;17;1023;1040
8;Barcelona;2;Catalunya Central;24;Osona;08285;Torelló;2;1;;1322;463;699;913;409;3;12;898;910
8;Barcelona;2;Catalunya Central;24;Osona;08285;Torelló;2;2;;1020;412;585;738;282;4;18;716;734
8;Barcelona;2;Catalunya Central;24;Osona;08285;Torelló;3;1;;1342;455;704;895;447;6;20;869;889
8;Barcelona;2;Catalunya Central;24;Osona;08285;Torelló;3;2;;1136;414;568;702;434;2;16;684;700
8;Barcelona;2;Catalunya Central;24;Osona;08285;Torelló;3;3;;1684;589;874;1121;563;9;18;1094;1112
25;Lleida;4;Lleida;18;Garrigues;25224;Torms, els;1;1;;125;40;74;102;23;1;1;100;101
25;Lleida;4;Lleida;38;Urgell;25225;Tornabous;1;1;;585;260;347;442;143;1;8;433;441
25;Lleida;4;Lleida;33;Segrià;25226;Torrebesses;1;1;;245;88;131;162;83;3;23;136;159
25;Lleida;5;Alt Pirineu i territori d'Aran;25;Pallars Jussà;25227;Torre de Cabdella, la;1;1;;665;221;319;522;143;12;24;486;510
8;Barcelona;8;Penedès;6;Anoia;08286;Torre de Claramunt, la;1;1;;1802;737;1050;1301;501;9;23;1269;1292
8;Barcelona;8;Penedès;6;Anoia;08286;Torre de Claramunt, la;1;2;;1138;408;540;654;484;6;6;642;648
43;Tarragona;6;Camp de Tarragona;29;Priorat;43151;Torre de Fontaubella, la;1;1;;108;75;85;99;9;2;0;97;97
43;Tarragona;7;Terres de l'Ebre;30;Ribera d'Ebre;43152;Torre de l'Espanyol, la;1;1;;437;200;261;336;101;25;20;291;311
43;Tarragona;6;Camp de Tarragona;36;Tarragonès;43153;Torredembarra;1;1;;1614;587;811;999;615;4;6;989;995
43;Tarragona;6;Camp de Tarragona;36;Tarragonès;43153;Torredembarra;1;2;;989;334;464;610;379;3;2;605;607
43;Tarragona;6;Camp de Tarragona;36;Tarragonès;43153;Torredembarra;1;3;;1284;497;685;845;439;5;8;832;840
43;Tarragona;6;Camp de Tarragona;36;Tarragonès;43153;Torredembarra;1;4;;1604;621;862;1113;491;3;12;1098;1110
43;Tarragona;6;Camp de Tarragona;36;Tarragonès;43153;Torredembarra;1;5;;1365;471;650;829;536;4;7;818;825
43;Tarragona;6;Camp de Tarragona;36;Tarragonès;43153;Torredembarra;1;6;;1954;696;921;1118;836;9;4;1105;1109
43;Tarragona;6;Camp de Tarragona;36;Tarragonès;43153;Torredembarra;1;7;;1410;497;653;808;602;1;2;805;807
43;Tarragona;6;Camp de Tarragona;36;Tarragonès;43153;Torredembarra;1;8;;1056;338;464;581;475;1;2;578;580
25;Lleida;4;Lleida;33;Segrià;25228;Torrefarrera;1;1;;1255;435;638;830;425;9;11;810;821
25;Lleida;4;Lleida;33;Segrià;25228;Torrefarrera;1;2;;1924;683;1017;1339;585;7;19;1313;1332
25;Lleida;4;Lleida;32;Segarra;25907;Torrefeta i Florejacs;1;1;;497;188;285;367;130;2;12;353;365
25;Lleida;4;Lleida;27;Pla d'Urgell;25230;Torregrossa;1;1;;1573;626;924;1144;429;70;62;1012;1074
25;Lleida;4;Lleida;23;Noguera;25231;Torrelameu;1;1;;509;256;354;454;55;11;6;437;443
8;Barcelona;8;Penedès;3;Alt Penedès;08287;Torrelavit;1;1;;1060;418;652;836;224;7;18;811;829
8;Barcelona;8;Penedès;3;Alt Penedès;08288;Torrelles de Foix;1;1;;1693;650;934;1133;560;14;17;1102;1119
8;Barcelona;1;Barcelona;11;Baix Llobregat;08289;Torrelles de Llobregat;1;1;;1007;317;553;713;294;7;8;698;706
8;Barcelona;1;Barcelona;11;Baix Llobregat;08289;Torrelles de Llobregat;1;2;;1203;351;545;731;472;0;10;721;731
8;Barcelona;1;Barcelona;11;Baix Llobregat;08289;Torrelles de Llobregat;1;3;;1433;474;694;898;535;4;17;877;894
8;Barcelona;1;Barcelona;11;Baix Llobregat;08289;Torrelles de Llobregat;1;4;;851;293;462;606;245;3;8;595;603
17;Girona;3;Girona;10;Baix Empordà;17197;Torrent;1;1;;130;68;87;102;28;1;1;100;101
25;Lleida;4;Lleida;33;Segrià;25232;Torres de Segre;1;1;;1391;557;834;1042;349;22;14;1006;1020
25;Lleida;4;Lleida;33;Segrià;25233;Torre-serona;1;1;;293;126;206;255;38;4;4;247;251
17;Girona;3;Girona;2;Alt Empordà;17198;Torroella de Fluvià;1;1;;492;203;287;368;124;2;7;359;366
17;Girona;3;Girona;10;Baix Empordà;17199;Torroella de Montgrí;1;1;;1163;420;604;799;364;3;18;778;796
17;Girona;3;Girona;10;Baix Empordà;17199;Torroella de Montgrí;1;2;;634;261;334;430;204;4;15;411;426
17;Girona;3;Girona;10;Baix Empordà;17199;Torroella de Montgrí;1;3;;1744;547;831;1049;695;15;14;1020;1034
17;Girona;3;Girona;10;Baix Empordà;17199;Torroella de Montgrí;1;4;;1402;564;809;996;406;10;15;971;986
17;Girona;3;Girona;10;Baix Empordà;17199;Torroella de Montgrí;1;5;;741;286;384;495;246;6;4;485;489
17;Girona;3;Girona;10;Baix Empordà;17199;Torroella de Montgrí;1;6;;1063;374;526;688;375;4;11;673;684
17;Girona;3;Girona;10;Baix Empordà;17199;Torroella de Montgrí;1;7;;851;252;371;498;353;6;7;485;492
43;Tarragona;6;Camp de Tarragona;29;Priorat;43154;Torroja del Priorat;1;1;;126;64;85;113;13;0;3;110;113
17;Girona;3;Girona;19;Garrotxa;17200;Tortellà;1;1;;633;327;440;517;116;14;26;477;503
43;Tarragona;7;Terres de l'Ebre;9;Baix Ebre;43155;Tortosa;1;1;;678;243;318;400;278;3;0;397;397
43;Tarragona;7;Terres de l'Ebre;9;Baix Ebre;43155;Tortosa;1;2;;512;207;271;340;172;1;5;334;339
43;Tarragona;7;Terres de l'Ebre;9;Baix Ebre;43155;Tortosa;1;3;;844;380;472;615;229;2;2;611;613
43;Tarragona;7;Terres de l'Ebre;9;Baix Ebre;43155;Tortosa;1;4;;1309;549;709;935;374;5;10;920;930
43;Tarragona;7;Terres de l'Ebre;9;Baix Ebre;43155;Tortosa;1;5;;591;190;240;293;298;3;0;290;290
43;Tarragona;7;Terres de l'Ebre;9;Baix Ebre;43155;Tortosa;1;6;;775;292;370;476;299;0;4;472;476
43;Tarragona;7;Terres de l'Ebre;9;Baix Ebre;43155;Tortosa;1;7;;1977;809;1053;1364;613;4;17;1343;1360
43;Tarragona;7;Terres de l'Ebre;9;Baix Ebre;43155;Tortosa;2;2;;1545;616;861;1092;453;11;12;1069;1081
43;Tarragona;7;Terres de l'Ebre;9;Baix Ebre;43155;Tortosa;2;3;;1163;433;579;778;385;3;11;764;775
43;Tarragona;7;Terres de l'Ebre;9;Baix Ebre;43155;Tortosa;2;4;;625;228;295;390;235;3;3;384;387
43;Tarragona;7;Terres de l'Ebre;9;Baix Ebre;43155;Tortosa;2;5;;923;420;572;698;225;6;25;667;692
43;Tarragona;7;Terres de l'Ebre;9;Baix Ebre;43155;Tortosa;3;1;;1344;477;609;775;569;5;7;763;770
43;Tarragona;7;Terres de l'Ebre;9;Baix Ebre;43155;Tortosa;3;2;;888;413;554;702;186;6;5;691;696
43;Tarragona;7;Terres de l'Ebre;9;Baix Ebre;43155;Tortosa;3;4;;1279;528;679;857;422;6;3;848;851
43;Tarragona;7;Terres de l'Ebre;9;Baix Ebre;43155;Tortosa;4;1;;1096;483;582;730;366;4;5;721;726
43;Tarragona;7;Terres de l'Ebre;9;Baix Ebre;43155;Tortosa;4;2;;890;328;448;558;332;4;3;551;554
43;Tarragona;7;Terres de l'Ebre;9;Baix Ebre;43155;Tortosa;4;3;;1042;341;474;595;447;7;4;584;588
43;Tarragona;7;Terres de l'Ebre;9;Baix Ebre;43155;Tortosa;4;4;;621;182;262;348;273;2;1;345;346
43;Tarragona;7;Terres de l'Ebre;9;Baix Ebre;43155;Tortosa;4;5;;1180;490;633;830;350;13;4;813;817
43;Tarragona;7;Terres de l'Ebre;9;Baix Ebre;43155;Tortosa;4;6;;1016;396;532;681;335;7;11;663;674
43;Tarragona;7;Terres de l'Ebre;9;Baix Ebre;43155;Tortosa;4;7;;804;265;384;549;255;3;7;539;546
43;Tarragona;7;Terres de l'Ebre;9;Baix Ebre;43155;Tortosa;4;8;;623;271;335;437;186;2;3;432;435
43;Tarragona;7;Terres de l'Ebre;9;Baix Ebre;43155;Tortosa;4;9;;1046;391;514;673;373;7;4;662;666
17;Girona;3;Girona;31;Ripollès;17201;Toses;1;1;;144;56;80;119;25;0;1;118;119
17;Girona;3;Girona;34;Selva;17202;Tossa de Mar;1;1;;885;327;496;617;268;7;7;603;610
17;Girona;3;Girona;34;Selva;17202;Tossa de Mar;1;2;;1155;403;630;785;370;13;14;758;772
17;Girona;3;Girona;34;Selva;17202;Tossa de Mar;1;3;;1880;686;1064;1346;534;11;25;1310;1335
25;Lleida;5;Alt Pirineu i territori d'Aran;25;Pallars Jussà;25234;Tremp;1;1;;623;238;439;386;237;7;11;368;379
25;Lleida;5;Alt Pirineu i territori d'Aran;25;Pallars Jussà;25234;Tremp;1;2;;823;324;439;566;257;10;19;537;556
25;Lleida;5;Alt Pirineu i territori d'Aran;25;Pallars Jussà;25234;Tremp;2;1;;1141;437;624;785;356;9;12;764;776
25;Lleida;5;Alt Pirineu i territori d'Aran;25;Pallars Jussà;25234;Tremp;2;2;;1158;391;608;813;345;16;24;773;797
25;Lleida;5;Alt Pirineu i territori d'Aran;25;Pallars Jussà;25234;Tremp;3;1;;475;159;215;306;169;9;7;290;297
17;Girona;3;Girona;10;Baix Empordà;17204;Ullà;1;1;;613;241;380;463;150;4;12;447;459
8;Barcelona;1;Barcelona;40;Vallès Occidental;08290;Ullastrell;1;1;;1541;616;917;1142;399;13;28;1101;1129
17;Girona;3;Girona;10;Baix Empordà;17205;Ullastret;1;1;;222;113;157;206;16;2;1;203;204
43;Tarragona;7;Terres de l'Ebre;22;Montsià;43156;Ulldecona;1;1;;1354;559;784;1013;341;19;10;984;994
43;Tarragona;7;Terres de l'Ebre;22;Montsià;43156;Ulldecona;1;2;;1715;722;978;1251;464;10;10;1231;1241
43;Tarragona;7;Terres de l'Ebre;22;Montsià;43156;Ulldecona;2;1;;1098;453;598;766;332;7;6;753;759
43;Tarragona;6;Camp de Tarragona;29;Priorat;43157;Ulldemolins;1;1;;344;205;252;313;31;0;5;308;313
17;Girona;3;Girona;10;Baix Empordà;17203;Ultramort;1;1;;176;92;130;160;16;6;2;152;154
17;Girona;5;Alt Pirineu i territori d'Aran;15;Cerdanya;17206;Urús;1;1;;156;62;88;116;40;1;0;115;115
8;Barcelona;1;Barcelona;40;Vallès Occidental;08291;Vacarisses;1;1;;1126;426;634;784;342;0;5;779;784
8;Barcelona;1;Barcelona;40;Vallès Occidental;08291;Vacarisses;1;2;;1619;615;872;1092;527;8;12;1072;1084
8;Barcelona;1;Barcelona;40;Vallès Occidental;08291;Vacarisses;1;3;;1420;445;694;866;554;3;4;859;863
8;Barcelona;1;Barcelona;40;Vallès Occidental;08291;Vacarisses;1;4;;808;229;329;440;368;4;3;433;436
17;Girona;3;Girona;2;Alt Empordà;17014;Vajol, la;1;1;;69;36;51;59;10;1;0;58;58
8;Barcelona;8;Penedès;6;Anoia;08292;Vallbona d'Anoia;1;1;;1063;500;701;828;235;13;5;810;815
25;Lleida;4;Lleida;38;Urgell;25238;Vallbona de les Monges;1;1;;207;110;137;172;35;3;2;167;169
8;Barcelona;2;Catalunya Central;14;Berguedà;08293;Vallcebre;1;1;;229;122;171;198;31;4;3;191;194
43;Tarragona;6;Camp de Tarragona;16;Conca de Barberà;43158;Vallclara;1;1;;77;35;51;60;17;1;3;56;59
17;Girona;3;Girona;19;Garrotxa;17207;Vall d'en Bas, la;1;1;;1174;592;795;969;205;9;13;947;960
17;Girona;3;Girona;19;Garrotxa;17207;Vall d'en Bas, la;1;2;;1257;504;751;986;271;16;32;938;970
17;Girona;3;Girona;19;Garrotxa;17208;Vall de Bianya, la;1;1;;979;397;554;699;280;14;44;641;685
25;Lleida;5;Alt Pirineu i territori d'Aran;5;Alta Ribagorça;25043;Vall de Boí, la;1;1;;805;289;400;621;184;13;14;594;608
25;Lleida;5;Alt Pirineu i territori d'Aran;26;Pallars Sobirà;25901;Vall de Cardós;1;1;;293;88;162;234;59;18;10;206;216
25;Lleida;4;Lleida;23;Noguera;25240;Vallfogona de Balaguer;1;1;;1412;561;798;1028;384;29;39;960;999
17;Girona;3;Girona;31;Ripollès;17170;Vallfogona de Ripollès;1;1;;183;79;117;151;32;4;13;134;147
43;Tarragona;6;Camp de Tarragona;16;Conca de Barberà;43159;Vallfogona de Riucorb;1;1;;82;37;48;64;18;0;9;55;64
8;Barcelona;1;Barcelona;41;Vallès Oriental;08294;Vallgorguina;1;1;;2087;787;1099;1419;668;16;40;1363;1403
8;Barcelona;1;Barcelona;11;Baix Llobregat;08295;Vallirana;1;1;;1903;686;926;1148;755;1;13;1134;1147
8;Barcelona;1;Barcelona;11;Baix Llobregat;08295;Vallirana;1;2;;1751;641;892;1116;635;3;9;1104;1113
8;Barcelona;1;Barcelona;11;Baix Llobregat;08295;Vallirana;1;3;;1369;454;704;878;491;2;4;872;876
8;Barcelona;1;Barcelona;11;Baix Llobregat;08295;Vallirana;1;4;;805;314;428;544;261;1;10;533;543
8;Barcelona;1;Barcelona;11;Baix Llobregat;08295;Vallirana;1;5;;913;313;438;564;349;1;2;561;563
8;Barcelona;1;Barcelona;11;Baix Llobregat;08295;Vallirana;1;6;;1471;485;698;860;611;9;6;845;851
8;Barcelona;1;Barcelona;11;Baix Llobregat;08295;Vallirana;1;7;;2071;634;902;1191;880;12;13;1166;1179
8;Barcelona;1;Barcelona;11;Baix Llobregat;08295;Vallirana;1;8;;999;342;496;599;400;1;3;595;598
17;Girona;3;Girona;10;Baix Empordà;17209;Vall-llobrega;1;1;;646;255;401;506;140;9;35;462;497
43;Tarragona;6;Camp de Tarragona;1;Alt Camp;43160;Vallmoll;1;1;;1334;611;846;1024;310;5;21;998;1019
8;Barcelona;1;Barcelona;41;Vallès Oriental;08296;Vallromanes;1;1;;1869;699;1000;1402;467;4;21;1377;1398
43;Tarragona;6;Camp de Tarragona;1;Alt Camp;43161;Valls;1;1;;535;176;230;287;248;0;2;285;287
43;Tarragona;6;Camp de Tarragona;1;Alt Camp;43161;Valls;2;1;;525;152;217;269;256;3;3;263;266
43;Tarragona;6;Camp de Tarragona;1;Alt Camp;43161;Valls;3;1;;1252;464;617;772;480;3;8;761;769
43;Tarragona;6;Camp de Tarragona;1;Alt Camp;43161;Valls;4;1;;873;393;525;634;239;3;8;623;631
43;Tarragona;6;Camp de Tarragona;1;Alt Camp;43161;Valls;4;2;;1256;445;626;781;475;7;8;766;774
43;Tarragona;6;Camp de Tarragona;1;Alt Camp;43161;Valls;4;3;;1243;403;562;761;482;6;3;752;755
43;Tarragona;6;Camp de Tarragona;1;Alt Camp;43161;Valls;5;1;;1300;560;721;891;409;6;11;874;885
43;Tarragona;6;Camp de Tarragona;1;Alt Camp;43161;Valls;5;2;;1789;634;904;1175;614;5;11;1159;1170
43;Tarragona;6;Camp de Tarragona;1;Alt Camp;43161;Valls;5;3;;877;342;438;518;359;3;4;511;515
43;Tarragona;6;Camp de Tarragona;1;Alt Camp;43161;Valls;6;1;;1644;714;879;1080;564;10;11;1059;1070
43;Tarragona;6;Camp de Tarragona;1;Alt Camp;43161;Valls;6;2;;1662;647;880;1126;536;8;16;1102;1118
43;Tarragona;6;Camp de Tarragona;1;Alt Camp;43161;Valls;6;3;;1224;515;701;869;355;1;12;856;868
43;Tarragona;6;Camp de Tarragona;1;Alt Camp;43161;Valls;6;4;;786;326;405;502;284;2;5;495;500
43;Tarragona;6;Camp de Tarragona;1;Alt Camp;43161;Valls;6;5;;1279;501;660;842;437;0;5;837;842
43;Tarragona;6;Camp de Tarragona;1;Alt Camp;43161;Valls;6;6;;956;318;455;614;342;3;9;602;611
25;Lleida;5;Alt Pirineu i territori d'Aran;4;Alt Urgell;25906;Valls d'Aguilar, les;1;1;;246;105;141;201;45;1;1;199;200
25;Lleida;5;Alt Pirineu i territori d'Aran;4;Alt Urgell;25239;Valls de Valira, les;1;1;;609;190;277;363;246;9;4;350;354
43;Tarragona;6;Camp de Tarragona;8;Baix Camp;43162;Vandellòs i l'Hospitalet de l'Infant;1;1;;753;342;493;619;134;5;4;610;614
43;Tarragona;6;Camp de Tarragona;8;Baix Camp;43162;Vandellòs i l'Hospitalet de l'Infant;1;2;;988;377;515;667;321;4;6;657;663
43;Tarragona;6;Camp de Tarragona;8;Baix Camp;43162;Vandellòs i l'Hospitalet de l'Infant;1;3;;1760;648;954;1163;597;11;6;1146;1152
43;Tarragona;6;Camp de Tarragona;8;Baix Camp;43162;Vandellòs i l'Hospitalet de l'Infant;1;4;;977;358;484;630;347;3;4;623;627
25;Lleida;5;Alt Pirineu i territori d'Aran;4;Alt Urgell;25909;Vansa i Fórnols, la;1;1;;146;67;89;110;36;0;0;110;110
8;Barcelona;2;Catalunya Central;6;Anoia;08297;Veciana;1;1;;139;48;99;121;18;1;4;116;120
43;Tarragona;8;Penedès;12;Baix Penedès;43163;Vendrell, el;1;1;;974;378;526;651;323;1;5;645;650
43;Tarragona;8;Penedès;12;Baix Penedès;43163;Vendrell, el;1;2;;996;383;525;631;365;8;8;615;623
43;Tarragona;8;Penedès;12;Baix Penedès;43163;Vendrell, el;1;3;;1274;421;565;716;558;3;5;708;713
43;Tarragona;8;Penedès;12;Baix Penedès;43163;Vendrell, el;2;1;;834;307;417;497;337;6;3;488;491
43;Tarragona;8;Penedès;12;Baix Penedès;43163;Vendrell, el;2;2;;1387;458;601;710;677;4;5;701;706
43;Tarragona;8;Penedès;12;Baix Penedès;43163;Vendrell, el;2;3;;1656;529;716;872;784;11;11;850;861
43;Tarragona;8;Penedès;12;Baix Penedès;43163;Vendrell, el;2;4;;1647;481;643;784;863;15;1;768;769
43;Tarragona;8;Penedès;12;Baix Penedès;43163;Vendrell, el;2;5;;1871;586;784;968;903;9;11;948;959
43;Tarragona;8;Penedès;12;Baix Penedès;43163;Vendrell, el;3;1;;1109;383;541;681;428;5;6;670;676
43;Tarragona;8;Penedès;12;Baix Penedès;43163;Vendrell, el;3;10;;683;201;356;462;221;7;5;450;455
43;Tarragona;8;Penedès;12;Baix Penedès;43163;Vendrell, el;3;11;;1015;369;492;623;392;4;5;614;619
43;Tarragona;8;Penedès;12;Baix Penedès;43163;Vendrell, el;3;12;;1458;464;656;820;638;2;2;816;818
43;Tarragona;8;Penedès;12;Baix Penedès;43163;Vendrell, el;3;13;;841;315;413;510;331;0;5;505;510
43;Tarragona;8;Penedès;12;Baix Penedès;43163;Vendrell, el;3;2;;1625;550;743;877;748;1;7;869;876
43;Tarragona;8;Penedès;12;Baix Penedès;43163;Vendrell, el;3;3;;1351;468;632;747;604;4;5;738;743
43;Tarragona;8;Penedès;12;Baix Penedès;43163;Vendrell, el;3;4;;1229;419;570;703;526;9;1;693;694
43;Tarragona;8;Penedès;12;Baix Penedès;43163;Vendrell, el;3;5;;907;335;460;570;337;3;5;562;567
43;Tarragona;8;Penedès;12;Baix Penedès;43163;Vendrell, el;3;6;;1464;534;724;892;572;8;7;877;884
43;Tarragona;8;Penedès;12;Baix Penedès;43163;Vendrell, el;3;7;;922;310;430;523;399;1;3;519;522
43;Tarragona;8;Penedès;12;Baix Penedès;43163;Vendrell, el;3;8;;1627;563;756;929;698;11;4;914;918
43;Tarragona;8;Penedès;12;Baix Penedès;43163;Vendrell, el;3;9;;1347;356;535;689;658;1;3;685;688
17;Girona;3;Girona;2;Alt Empordà;17210;Ventalló;1;1;;602;261;350;435;167;4;21;410;431
25;Lleida;4;Lleida;38;Urgell;25242;Verdú;1;1;;705;327;448;538;167;8;7;523;530
17;Girona;3;Girona;10;Baix Empordà;17211;Verges;1;1;;843;328;514;631;212;18;98;515;613
43;Tarragona;6;Camp de Tarragona;36;Tarragonès;43164;Vespella de Gaià;1;1;;330;138;200;259;71;2;3;254;257
8;Barcelona;2;Catalunya Central;24;Osona;08298;Vic;1;1;;1504;647;867;1055;449;5;15;1035;1050
8;Barcelona;2;Catalunya Central;24;Osona;08298;Vic;2;1;;701;264;392;492;209;1;4;487;491
8;Barcelona;2;Catalunya Central;24;Osona;08298;Vic;2;2;;1691;597;914;1223;468;8;21;1194;1215
8;Barcelona;2;Catalunya Central;24;Osona;08298;Vic;2;3;;1445;580;794;997;448;3;12;982;994
8;Barcelona;2;Catalunya Central;24;Osona;08298;Vic;2;4;;1176;442;635;768;408;1;3;764;767
8;Barcelona;2;Catalunya Central;24;Osona;08298;Vic;2;5;;1464;564;788;1012;452;1;15;996;1011
8;Barcelona;2;Catalunya Central;24;Osona;08298;Vic;2;6;;1346;504;651;856;490;0;3;853;856
8;Barcelona;2;Catalunya Central;24;Osona;08298;Vic;3;1;;924;391;541;689;235;4;15;670;685
8;Barcelona;2;Catalunya Central;24;Osona;08298;Vic;3;10;;690;290;434;543;147;2;9;532;541
8;Barcelona;2;Catalunya Central;24;Osona;08298;Vic;3;11;;703;226;304;365;338;1;1;363;364
8;Barcelona;2;Catalunya Central;24;Osona;08298;Vic;3;12;;1504;608;854;1101;403;7;13;1081;1094
8;Barcelona;2;Catalunya Central;24;Osona;08298;Vic;3;13;;651;252;348;422;229;5;6;411;417
8;Barcelona;2;Catalunya Central;24;Osona;08298;Vic;3;3;;1344;490;656;851;493;6;8;837;845
8;Barcelona;2;Catalunya Central;24;Osona;08298;Vic;3;4;;606;223;338;405;201;2;5;398;403
8;Barcelona;2;Catalunya Central;24;Osona;08298;Vic;3;5;;1369;445;567;720;649;1;9;710;719
8;Barcelona;2;Catalunya Central;24;Osona;08298;Vic;3;6;;849;243;411;505;344;2;5;498;503
8;Barcelona;2;Catalunya Central;24;Osona;08298;Vic;3;7;;1497;539;829;1067;430;3;8;1056;1064
8;Barcelona;2;Catalunya Central;24;Osona;08298;Vic;3;8;;1154;329;504;644;510;0;4;640;644
8;Barcelona;2;Catalunya Central;24;Osona;08298;Vic;3;9;;606;252;332;408;198;3;0;405;405
8;Barcelona;2;Catalunya Central;24;Osona;08298;Vic;4;1;;1625;621;849;1075;550;7;13;1055;1068
8;Barcelona;2;Catalunya Central;24;Osona;08298;Vic;4;2;;1689;531;773;982;707;2;12;968;980
8;Barcelona;2;Catalunya Central;24;Osona;08298;Vic;4;3;;949;361;513;650;299;2;6;642;648
8;Barcelona;2;Catalunya Central;24;Osona;08298;Vic;4;4;;1133;385;556;708;425;2;11;695;706
8;Barcelona;2;Catalunya Central;24;Osona;08298;Vic;5;1;;591;225;356;467;124;2;9;456;465
17;Girona;2;Catalunya Central;24;Osona;17212;Vidrà;1;1;;145;60;97;118;27;1;9;108;117
17;Girona;3;Girona;34;Selva;17213;Vidreres;1;1;;1549;510;894;1080;469;8;31;1041;1072
17;Girona;3;Girona;34;Selva;17213;Vidreres;1;2;;974;299;508;612;362;7;7;598;605
17;Girona;3;Girona;34;Selva;17213;Vidreres;1;3;;1669;600;911;1100;569;7;21;1072;1093
17;Girona;3;Girona;34;Selva;17213;Vidreres;1;4;;1433;378;524;635;798;5;20;610;630
25;Lleida;5;Alt Pirineu i territori d'Aran;39;Consell General d'Aran;25243;Vielha e Mijaran;1;1;;1197;419;576;794;403;6;17;771;788
25;Lleida;5;Alt Pirineu i territori d'Aran;39;Consell General d'Aran;25243;Vielha e Mijaran;1;2;;1513;529;732;1065;448;5;15;1045;1060
25;Lleida;5;Alt Pirineu i territori d'Aran;39;Consell General d'Aran;25243;Vielha e Mijaran;1;3;;1137;366;530;755;382;6;6;743;749
43;Tarragona;6;Camp de Tarragona;1;Alt Camp;43165;Vilabella;1;1;;575;283;444;510;65;3;11;496;507
17;Girona;3;Girona;2;Alt Empordà;17214;Vilabertran;1;1;;730;266;366;471;259;22;72;377;449
17;Girona;3;Girona;20;Gironès;17215;Vilablareix;1;1;;1153;533;778;943;210;8;15;920;935
17;Girona;3;Girona;20;Gironès;17215;Vilablareix;1;2;;1075;478;662;845;230;2;15;828;843
8;Barcelona;2;Catalunya Central;14;Berguedà;08299;Vilada;1;1;;377;203;291;327;50;1;3;323;326
17;Girona;3;Girona;2;Alt Empordà;17217;Viladamat;1;1;;362;184;283;319;43;4;14;301;315
17;Girona;3;Girona;20;Gironès;17216;Viladasens;1;1;;157;71;117;137;20;2;0;135;135
8;Barcelona;1;Barcelona;11;Baix Llobregat;08301;Viladecans;1;1;;967;292;411;518;449;3;1;514;515
8;Barcelona;1;Barcelona;11;Baix Llobregat;08301;Viladecans;1;10;;979;317;438;561;418;0;3;558;561
8;Barcelona;1;Barcelona;11;Baix Llobregat;08301;Viladecans;1;11;;1224;472;650;826;398;2;4;820;824
8;Barcelona;1;Barcelona;11;Baix Llobregat;08301;Viladecans;1;12;;811;261;397;546;265;2;2;542;544
8;Barcelona;1;Barcelona;11;Baix Llobregat;08301;Viladecans;1;13;;977;318;460;608;369;1;2;605;607
8;Barcelona;1;Barcelona;11;Baix Llobregat;08301;Viladecans;1;14;;1616;523;717;968;648;3;2;963;965
8;Barcelona;1;Barcelona;11;Baix Llobregat;08301;Viladecans;1;15;;553;161;227;279;274;1;2;276;278
8;Barcelona;1;Barcelona;11;Baix Llobregat;08301;Viladecans;1;16;;1147;402;563;810;337;0;11;799;810
8;Barcelona;1;Barcelona;11;Baix Llobregat;08301;Viladecans;1;2;;1923;552;838;1063;860;6;5;1052;1057
8;Barcelona;1;Barcelona;11;Baix Llobregat;08301;Viladecans;1;3;;1922;647;995;1263;659;4;4;1255;1259
8;Barcelona;1;Barcelona;11;Baix Llobregat;08301;Viladecans;1;4;;1317;456;691;837;480;5;8;824;832
8;Barcelona;1;Barcelona;11;Baix Llobregat;08301;Viladecans;1;5;;650;237;430;423;227;2;1;420;421
8;Barcelona;1;Barcelona;11;Baix Llobregat;08301;Viladecans;1;6;;1231;452;608;762;469;8;2;752;754
8;Barcelona;1;Barcelona;11;Baix Llobregat;08301;Viladecans;1;7;;946;325;467;571;375;4;10;557;567
8;Barcelona;1;Barcelona;11;Baix Llobregat;08301;Viladecans;1;8;;947;335;465;588;359;4;8;576;584
8;Barcelona;1;Barcelona;11;Baix Llobregat;08301;Viladecans;1;9;;946;297;425;558;388;0;3;555;558
8;Barcelona;1;Barcelona;11;Baix Llobregat;08301;Viladecans;2;1;;992;296;397;490;502;5;2;483;485
8;Barcelona;1;Barcelona;11;Baix Llobregat;08301;Viladecans;2;10;;1142;393;497;621;521;1;4;616;620
8;Barcelona;1;Barcelona;11;Baix Llobregat;08301;Viladecans;2;11;;840;256;383;501;339;2;2;497;499
8;Barcelona;1;Barcelona;11;Baix Llobregat;08301;Viladecans;2;12;;1028;333;472;577;451;0;4;573;577
8;Barcelona;1;Barcelona;11;Baix Llobregat;08301;Viladecans;2;13;;1109;408;520;633;476;3;2;628;630
8;Barcelona;1;Barcelona;11;Baix Llobregat;08301;Viladecans;2;14;;774;243;352;439;335;3;3;433;436
8;Barcelona;1;Barcelona;11;Baix Llobregat;08301;Viladecans;2;15;;1447;483;654;845;602;5;5;835;840
8;Barcelona;1;Barcelona;11;Baix Llobregat;08301;Viladecans;2;16;;1377;362;686;869;508;3;5;861;866
8;Barcelona;1;Barcelona;11;Baix Llobregat;08301;Viladecans;2;17;;1315;421;611;761;554;3;4;754;758
8;Barcelona;1;Barcelona;11;Baix Llobregat;08301;Viladecans;2;18;;638;213;251;317;321;3;1;313;314
8;Barcelona;1;Barcelona;11;Baix Llobregat;08301;Viladecans;2;19;;550;196;253;322;228;2;1;319;320
8;Barcelona;1;Barcelona;11;Baix Llobregat;08301;Viladecans;2;2;;1082;323;477;596;486;6;2;588;590
8;Barcelona;1;Barcelona;11;Baix Llobregat;08301;Viladecans;2;20;;1362;468;644;834;528;4;3;827;830
8;Barcelona;1;Barcelona;11;Baix Llobregat;08301;Viladecans;2;21;;894;304;443;526;368;3;1;522;523
8;Barcelona;1;Barcelona;11;Baix Llobregat;08301;Viladecans;2;22;;1326;479;656;829;497;2;1;826;827
8;Barcelona;1;Barcelona;11;Baix Llobregat;08301;Viladecans;2;23;;951;314;456;572;379;4;1;567;568
8;Barcelona;1;Barcelona;11;Baix Llobregat;08301;Viladecans;2;24;;745;214;322;413;332;1;8;404;412
8;Barcelona;1;Barcelona;11;Baix Llobregat;08301;Viladecans;2;25;;1445;433;593;808;637;1;3;804;807
8;Barcelona;1;Barcelona;11;Baix Llobregat;08301;Viladecans;2;26;;1253;437;628;809;444;7;3;799;802
8;Barcelona;1;Barcelona;11;Baix Llobregat;08301;Viladecans;2;27;;796;264;365;494;302;0;2;492;494
8;Barcelona;1;Barcelona;11;Baix Llobregat;08301;Viladecans;2;28;;886;297;447;594;292;2;7;585;592
8;Barcelona;1;Barcelona;11;Baix Llobregat;08301;Viladecans;2;29;;1656;501;783;1062;594;6;4;1052;1056
8;Barcelona;1;Barcelona;11;Baix Llobregat;08301;Viladecans;2;3;;1608;530;786;1023;585;4;8;1011;1019
8;Barcelona;1;Barcelona;11;Baix Llobregat;08301;Viladecans;2;4;;833;261;374;472;361;0;2;470;472
8;Barcelona;1;Barcelona;11;Baix Llobregat;08301;Viladecans;2;5;;843;281;408;500;343;2;1;497;498
8;Barcelona;1;Barcelona;11;Baix Llobregat;08301;Viladecans;2;6;;1039;344;471;582;457;3;3;576;579
8;Barcelona;1;Barcelona;11;Baix Llobregat;08301;Viladecans;2;7;;1059;311;440;556;503;3;1;552;553
8;Barcelona;1;Barcelona;11;Baix Llobregat;08301;Viladecans;2;8;;1074;346;490;637;437;3;5;629;634
8;Barcelona;1;Barcelona;11;Baix Llobregat;08301;Viladecans;2;9;;1118;349;474;589;529;4;2;583;585
8;Barcelona;1;Barcelona;40;Vallès Occidental;08300;Viladecavalls;1;1;;1519;554;879;1144;375;8;10;1126;1136
8;Barcelona;1;Barcelona;40;Vallès Occidental;08300;Viladecavalls;1;2;;1937;653;992;1251;686;7;7;1237;1244
8;Barcelona;1;Barcelona;40;Vallès Occidental;08300;Viladecavalls;1;3;;1078;334;498;647;431;3;3;641;644
8;Barcelona;1;Barcelona;40;Vallès Occidental;08300;Viladecavalls;1;4;;806;308;459;590;216;2;6;582;588
8;Barcelona;1;Barcelona;40;Vallès Occidental;08300;Viladecavalls;1;6;;570;209;289;385;185;2;1;382;383
17;Girona;3;Girona;28;Pla de l'Estany;17218;Vilademuls;1;1;;584;266;348;447;137;11;26;410;436
17;Girona;2;Catalunya Central;24;Osona;17220;Viladrau;1;1;;810;404;568;693;117;7;11;675;686
17;Girona;3;Girona;2;Alt Empordà;17221;Vilafant;1;1;;962;414;563;642;320;3;5;634;639
17;Girona;3;Girona;2;Alt Empordà;17221;Vilafant;1;2;;775;258;380;511;264;1;3;507;510
17;Girona;3;Girona;2;Alt Empordà;17221;Vilafant;1;3;;1279;438;631;808;471;4;10;794;804
17;Girona;3;Girona;2;Alt Empordà;17221;Vilafant;1;4;;1135;484;648;792;343;3;6;783;789
8;Barcelona;8;Penedès;3;Alt Penedès;08305;Vilafranca del Penedès;1;1;;1166;456;607;754;412;3;8;743;751
8;Barcelona;8;Penedès;3;Alt Penedès;08305;Vilafranca del Penedès;1;2;;1749;657;957;1137;612;6;6;1125;1131
8;Barcelona;8;Penedès;3;Alt Penedès;08305;Vilafranca del Penedès;1;3;;699;263;368;453;246;0;1;452;453
8;Barcelona;8;Penedès;3;Alt Penedès;08305;Vilafranca del Penedès;2;1;;1399;542;698;880;519;8;7;865;872
8;Barcelona;8;Penedès;3;Alt Penedès;08305;Vilafranca del Penedès;2;2;;1304;538;716;897;407;1;2;894;896
8;Barcelona;8;Penedès;3;Alt Penedès;08305;Vilafranca del Penedès;2;3;;1005;330;456;567;438;0;4;563;567
8;Barcelona;8;Penedès;3;Alt Penedès;08305;Vilafranca del Penedès;2;4;;1129;362;493;638;491;4;5;629;634
8;Barcelona;8;Penedès;3;Alt Penedès;08305;Vilafranca del Penedès;2;5;;1494;549;846;1055;439;6;7;1042;1049
8;Barcelona;8;Penedès;3;Alt Penedès;08305;Vilafranca del Penedès;2;6;;1658;536;774;944;714;5;10;929;939
8;Barcelona;8;Penedès;3;Alt Penedès;08305;Vilafranca del Penedès;3;1;;1130;466;597;732;398;2;8;722;730
8;Barcelona;8;Penedès;3;Alt Penedès;08305;Vilafranca del Penedès;3;2;;799;343;459;592;207;2;7;583;590
8;Barcelona;8;Penedès;3;Alt Penedès;08305;Vilafranca del Penedès;3;3;;2020;694;956;1223;797;6;5;1212;1217
8;Barcelona;8;Penedès;3;Alt Penedès;08305;Vilafranca del Penedès;3;4;;1194;437;614;837;357;3;6;828;834
8;Barcelona;8;Penedès;3;Alt Penedès;08305;Vilafranca del Penedès;4;1;;1311;506;733;953;358;6;5;942;947
8;Barcelona;8;Penedès;3;Alt Penedès;08305;Vilafranca del Penedès;4;2;;1238;550;743;912;326;2;3;907;910
8;Barcelona;8;Penedès;3;Alt Penedès;08305;Vilafranca del Penedès;4;3;;1136;460;611;769;367;7;11;751;762
8;Barcelona;8;Penedès;3;Alt Penedès;08305;Vilafranca del Penedès;4;4;;1055;446;591;742;313;2;4;736;740
8;Barcelona;8;Penedès;3;Alt Penedès;08305;Vilafranca del Penedès;4;5;;1585;563;856;1084;501;5;7;1072;1079
8;Barcelona;8;Penedès;3;Alt Penedès;08305;Vilafranca del Penedès;4;6;;947;419;575;689;258;3;4;682;686
8;Barcelona;8;Penedès;3;Alt Penedès;08305;Vilafranca del Penedès;4;7;;907;324;488;643;264;4;1;638;639
8;Barcelona;8;Penedès;3;Alt Penedès;08305;Vilafranca del Penedès;4;8;;1528;539;790;1012;516;4;4;1004;1008
8;Barcelona;8;Penedès;3;Alt Penedès;08305;Vilafranca del Penedès;4;9;;1252;428;614;840;412;4;9;827;836
25;Lleida;4;Lleida;38;Urgell;25244;Vilagrassa;1;1;;370;159;251;306;64;4;2;300;302
17;Girona;3;Girona;2;Alt Empordà;17223;Vilajuïga;1;1;;833;381;518;652;181;2;11;639;650
43;Tarragona;7;Terres de l'Ebre;37;Terra Alta;43175;Vilalba dels Arcs;1;1;;541;257;363;459;82;11;21;427;448
8;Barcelona;1;Barcelona;41;Vallès Oriental;08306;Vilalba Sasserra;1;1;;530;190;275;337;193;4;18;315;333
25;Lleida;5;Alt Pirineu i territori d'Aran;5;Alta Ribagorça;25245;Vilaller;1;1;;446;208;276;340;106;21;29;290;319
43;Tarragona;6;Camp de Tarragona;36;Tarragonès;43166;Vilallonga del Camp;1;1;;1667;640;936;1202;465;11;21;1170;1191
17;Girona;3;Girona;31;Ripollès;17224;Vilallonga de Ter;1;1;;302;108;159;205;97;10;19;176;195
17;Girona;3;Girona;2;Alt Empordà;17225;Vilamacolum;1;1;;207;87;117;146;61;3;5;138;143
17;Girona;3;Girona;2;Alt Empordà;17226;Vilamalla;1;1;;898;318;429;550;348;24;68;458;526
17;Girona;3;Girona;2;Alt Empordà;17227;Vilamaniscle;1;1;;159;55;90;105;54;1;4;100;104
25;Lleida;5;Alt Pirineu i territori d'Aran;39;Consell General d'Aran;25247;Vilamòs;1;1;;148;69;88;125;23;0;2;123;125
17;Girona;3;Girona;2;Alt Empordà;17228;Vilanant;1;1;;289;126;172;221;68;3;12;206;218
43;Tarragona;6;Camp de Tarragona;8;Baix Camp;43167;Vilanova d'Escornalbou;1;1;;407;208;284;336;71;12;10;314;324
25;Lleida;4;Lleida;27;Pla d'Urgell;25248;Vilanova de Bellpuig;1;1;;873;440;620;739;134;14;9;716;725
25;Lleida;4;Lleida;23;Noguera;25249;Vilanova de l'Aguda;1;1;;176;89;113;144;32;5;6;133;139
25;Lleida;4;Lleida;33;Segrià;25254;Vilanova de la Barca;1;1;;751;344;462;597;154;34;19;544;563
8;Barcelona;8;Penedès;6;Anoia;08302;Vilanova del Camí;1;1;;1358;501;686;843;515;4;6;833;839
8;Barcelona;8;Penedès;6;Anoia;08302;Vilanova del Camí;1;2;;1454;504;708;914;540;4;8;902;910
8;Barcelona;8;Penedès;6;Anoia;08302;Vilanova del Camí;1;3;;1411;470;678;910;501;3;11;896;907
8;Barcelona;8;Penedès;6;Anoia;08302;Vilanova del Camí;1;4;;1349;507;694;907;442;2;4;901;905
8;Barcelona;8;Penedès;6;Anoia;08302;Vilanova del Camí;1;5;;1660;613;830;1074;586;2;4;1068;1072
8;Barcelona;8;Penedès;6;Anoia;08302;Vilanova del Camí;1;6;;864;284;431;555;309;2;8;545;553
8;Barcelona;8;Penedès;6;Anoia;08302;Vilanova del Camí;1;7;;1315;473;636;835;480;6;7;822;829
8;Barcelona;1;Barcelona;41;Vallès Oriental;08902;Vilanova del Vallès;1;1;;1708;641;976;1231;477;6;14;1211;1225
8;Barcelona;1;Barcelona;41;Vallès Oriental;08902;Vilanova del Vallès;1;2;;1007;375;534;678;329;6;9;663;672
8;Barcelona;1;Barcelona;41;Vallès Oriental;08902;Vilanova del Vallès;1;3;;1237;434;631;769;468;8;13;748;761
25;Lleida;4;Lleida;23;Noguera;25250;Vilanova de Meià;1;1;;336;159;231;274;62;7;13;254;267
43;Tarragona;6;Camp de Tarragona;16;Conca de Barberà;43168;Vilanova de Prades;1;1;;82;26;45;53;29;7;9;37;46
8;Barcelona;2;Catalunya Central;24;Osona;08303;Vilanova de Sau;1;1;;258;127;174;214;44;4;13;197;210
25;Lleida;4;Lleida;33;Segrià;25251;Vilanova de Segrià;1;1;;721;363;482;560;161;9;10;541;551
8;Barcelona;8;Penedès;17;Garraf;08307;Vilanova i la Geltrú;1;1;;1754;676;970;1155;599;6;4;1145;1149
8;Barcelona;8;Penedès;17;Garraf;08307;Vilanova i la Geltrú;1;10;;1075;446;618;770;305;3;4;763;767
8;Barcelona;8;Penedès;17;Garraf;08307;Vilanova i la Geltrú;1;11;;1168;399;556;716;452;1;6;709;715
8;Barcelona;8;Penedès;17;Garraf;08307;Vilanova i la Geltrú;1;2;;919;347;507;650;269;0;2;648;650
8;Barcelona;8;Penedès;17;Garraf;08307;Vilanova i la Geltrú;1;3;;1601;596;861;1047;554;1;7;1039;1046
8;Barcelona;8;Penedès;17;Garraf;08307;Vilanova i la Geltrú;1;4;;811;329;447;542;269;3;4;535;539
8;Barcelona;8;Penedès;17;Garraf;08307;Vilanova i la Geltrú;1;5;;693;290;405;480;213;1;1;478;479
8;Barcelona;8;Penedès;17;Garraf;08307;Vilanova i la Geltrú;1;6;;1263;467;648;826;437;4;2;820;822
8;Barcelona;8;Penedès;17;Garraf;08307;Vilanova i la Geltrú;1;7;;1473;519;750;915;558;6;1;908;909
8;Barcelona;8;Penedès;17;Garraf;08307;Vilanova i la Geltrú;1;8;;1848;635;930;1184;664;3;6;1175;1181
8;Barcelona;8;Penedès;17;Garraf;08307;Vilanova i la Geltrú;1;9;;1420;498;770;979;441;4;11;964;975
8;Barcelona;8;Penedès;17;Garraf;08307;Vilanova i la Geltrú;2;1;;2647;918;1325;1702;945;5;15;1682;1697
8;Barcelona;8;Penedès;17;Garraf;08307;Vilanova i la Geltrú;2;2;;1678;665;898;1089;589;2;7;1080;1087
8;Barcelona;8;Penedès;17;Garraf;08307;Vilanova i la Geltrú;2;3;;1372;441;640;819;553;5;3;811;814
8;Barcelona;8;Penedès;17;Garraf;08307;Vilanova i la Geltrú;2;4;;1579;591;801;991;588;0;3;988;991
8;Barcelona;8;Penedès;17;Garraf;08307;Vilanova i la Geltrú;2;5;;444;165;219;263;181;1;2;260;262
8;Barcelona;8;Penedès;17;Garraf;08307;Vilanova i la Geltrú;2;6;;1208;455;621;745;463;1;2;742;744
8;Barcelona;8;Penedès;17;Garraf;08307;Vilanova i la Geltrú;2;7;;1717;580;847;1050;667;1;10;1039;1049
8;Barcelona;8;Penedès;17;Garraf;08307;Vilanova i la Geltrú;3;1;;626;231;316;401;225;0;1;400;401
8;Barcelona;8;Penedès;17;Garraf;08307;Vilanova i la Geltrú;3;2;;1069;387;535;692;377;1;7;684;691
8;Barcelona;8;Penedès;17;Garraf;08307;Vilanova i la Geltrú;3;3;;898;339;484;597;301;3;5;589;594
8;Barcelona;8;Penedès;17;Garraf;08307;Vilanova i la Geltrú;3;4;;1808;517;796;992;816;5;4;983;987
8;Barcelona;8;Penedès;17;Garraf;08307;Vilanova i la Geltrú;3;5;;1128;307;415;549;579;5;0;544;544
8;Barcelona;8;Penedès;17;Garraf;08307;Vilanova i la Geltrú;4;1;;892;332;486;618;274;4;0;614;614
8;Barcelona;8;Penedès;17;Garraf;08307;Vilanova i la Geltrú;4;10;;1564;485;750;973;591;3;4;966;970
8;Barcelona;8;Penedès;17;Garraf;08307;Vilanova i la Geltrú;4;11;;1304;463;635;744;560;2;1;741;742
8;Barcelona;8;Penedès;17;Garraf;08307;Vilanova i la Geltrú;4;12;;1190;428;643;815;375;1;6;808;814
8;Barcelona;8;Penedès;17;Garraf;08307;Vilanova i la Geltrú;4;13;;1090;360;575;750;340;0;9;741;750
8;Barcelona;8;Penedès;17;Garraf;08307;Vilanova i la Geltrú;4;14;;1489;486;760;989;500;2;9;978;987
8;Barcelona;8;Penedès;17;Garraf;08307;Vilanova i la Geltrú;4;15;;1287;497;716;899;388;4;3;892;895
8;Barcelona;8;Penedès;17;Garraf;08307;Vilanova i la Geltrú;4;16;;1038;227;319;401;637;0;2;399;401
8;Barcelona;8;Penedès;17;Garraf;08307;Vilanova i la Geltrú;4;2;;568;200;295;369;199;0;1;368;369
8;Barcelona;8;Penedès;17;Garraf;08307;Vilanova i la Geltrú;4;3;;616;207;288;373;243;1;4;368;372
8;Barcelona;8;Penedès;17;Garraf;08307;Vilanova i la Geltrú;4;4;;1305;415;596;774;531;4;7;763;770
8;Barcelona;8;Penedès;17;Garraf;08307;Vilanova i la Geltrú;4;5;;1464;612;812;1006;458;1;6;999;1005
8;Barcelona;8;Penedès;17;Garraf;08307;Vilanova i la Geltrú;4;6;;1302;465;627;799;503;4;3;792;795
8;Barcelona;8;Penedès;17;Garraf;08307;Vilanova i la Geltrú;4;7;;2910;874;1300;1689;1221;1;0;1688;1688
8;Barcelona;8;Penedès;17;Garraf;08307;Vilanova i la Geltrú;4;8;;706;257;330;386;320;3;3;380;383
8;Barcelona;8;Penedès;17;Garraf;08307;Vilanova i la Geltrú;4;9;;841;350;488;580;261;0;2;578;580
43;Tarragona;6;Camp de Tarragona;8;Baix Camp;43169;Vilaplana;1;1;;457;190;284;371;86;31;38;302;340
43;Tarragona;6;Camp de Tarragona;1;Alt Camp;43170;Vila-rodona;1;1;;886;358;469;590;296;24;129;437;566
17;Girona;3;Girona;2;Alt Empordà;17230;Vila-sacra;1;1;;506;200;309;373;133;0;8;365;373
25;Lleida;4;Lleida;27;Pla d'Urgell;25252;Vila-sana;1;1;;574;257;346;450;124;6;9;435;444
43;Tarragona;6;Camp de Tarragona;36;Tarragonès;43171;Vila-seca;1;1;;1713;633;875;1118;595;4;19;1095;1114
43;Tarragona;6;Camp de Tarragona;36;Tarragonès;43171;Vila-seca;1;10;;1077;370;487;649;428;1;12;636;648
43;Tarragona;6;Camp de Tarragona;36;Tarragonès;43171;Vila-seca;1;11;;1786;582;842;1133;653;6;20;1107;1127
43;Tarragona;6;Camp de Tarragona;36;Tarragonès;43171;Vila-seca;1;12;;526;180;271;359;167;0;3;356;359
43;Tarragona;6;Camp de Tarragona;36;Tarragonès;43171;Vila-seca;1;2;;1668;631;879;1069;599;13;6;1050;1056
43;Tarragona;6;Camp de Tarragona;36;Tarragonès;43171;Vila-seca;1;3;;868;303;386;500;368;2;2;496;498
43;Tarragona;6;Camp de Tarragona;36;Tarragonès;43171;Vila-seca;1;4;;593;258;346;410;183;1;2;407;409
43;Tarragona;6;Camp de Tarragona;36;Tarragonès;43171;Vila-seca;1;5;;988;382;492;599;389;7;4;588;592
43;Tarragona;6;Camp de Tarragona;36;Tarragonès;43171;Vila-seca;1;6;;1151;465;600;736;415;1;11;724;735
43;Tarragona;6;Camp de Tarragona;36;Tarragonès;43171;Vila-seca;1;7;;1532;460;690;897;635;13;12;872;884
43;Tarragona;6;Camp de Tarragona;36;Tarragonès;43171;Vila-seca;1;8;;1789;472;659;857;932;6;6;845;851
43;Tarragona;6;Camp de Tarragona;36;Tarragonès;43171;Vila-seca;1;9;;1161;437;606;749;412;2;3;744;747
8;Barcelona;1;Barcelona;21;Maresme;08214;Vilassar de Dalt;1;1;;1100;412;589;724;376;5;14;705;719
8;Barcelona;1;Barcelona;21;Maresme;08214;Vilassar de Dalt;1;2;;776;254;380;478;298;7;11;460;471
8;Barcelona;1;Barcelona;21;Maresme;08214;Vilassar de Dalt;1;3;;1160;405;586;767;393;3;17;747;764
8;Barcelona;1;Barcelona;21;Maresme;08214;Vilassar de Dalt;1;4;;1088;412;602;785;303;9;13;763;776
8;Barcelona;1;Barcelona;21;Maresme;08214;Vilassar de Dalt;2;1;;1780;692;965;1257;523;6;43;1208;1251
8;Barcelona;1;Barcelona;21;Maresme;08214;Vilassar de Dalt;2;2;;1105;412;557;704;401;9;10;685;695
8;Barcelona;1;Barcelona;21;Maresme;08219;Vilassar de Mar;1;1;;807;288;426;562;245;1;6;555;561
8;Barcelona;1;Barcelona;21;Maresme;08219;Vilassar de Mar;1;2;;1457;612;872;1101;356;7;8;1086;1094
8;Barcelona;1;Barcelona;21;Maresme;08219;Vilassar de Mar;1;3;;1636;614;896;1121;515;5;12;1104;1116
8;Barcelona;1;Barcelona;21;Maresme;08219;Vilassar de Mar;1;4;;1567;574;821;1128;439;5;7;1116;1123
8;Barcelona;1;Barcelona;21;Maresme;08219;Vilassar de Mar;1;5;;1041;399;570;726;315;3;14;709;723
8;Barcelona;1;Barcelona;21;Maresme;08219;Vilassar de Mar;1;6;;1030;440;612;736;294;7;6;723;729
8;Barcelona;1;Barcelona;21;Maresme;08219;Vilassar de Mar;2;1;;943;367;525;659;284;3;3;653;656
8;Barcelona;1;Barcelona;21;Maresme;08219;Vilassar de Mar;2;2;;968;388;598;721;247;2;12;707;719
8;Barcelona;1;Barcelona;21;Maresme;08219;Vilassar de Mar;2;3;;941;353;524;663;278;3;5;655;660
8;Barcelona;1;Barcelona;21;Maresme;08219;Vilassar de Mar;2;4;;1008;394;563;724;284;2;7;715;722
8;Barcelona;1;Barcelona;21;Maresme;08219;Vilassar de Mar;2;5;;985;377;576;714;271;2;6;706;712
8;Barcelona;1;Barcelona;21;Maresme;08219;Vilassar de Mar;3;1;;1062;410;585;732;330;3;4;725;729
8;Barcelona;1;Barcelona;21;Maresme;08219;Vilassar de Mar;3;2;;861;305;461;596;265;3;3;590;593
8;Barcelona;1;Barcelona;21;Maresme;08219;Vilassar de Mar;3;3;;789;256;353;448;341;1;0;447;447
8;Barcelona;1;Barcelona;21;Maresme;08219;Vilassar de Mar;3;4;;707;215;325;390;317;1;2;387;389
17;Girona;3;Girona;2;Alt Empordà;17222;Vilaür;1;1;;106;47;78;92;14;4;0;88;88
43;Tarragona;6;Camp de Tarragona;16;Conca de Barberà;43172;Vilaverd;1;1;;349;112;175;221;128;42;21;158;179
43;Tarragona;6;Camp de Tarragona;29;Priorat;43173;Vilella Alta, la;1;1;;99;35;55;75;24;10;0;65;65
43;Tarragona;6;Camp de Tarragona;29;Priorat;43174;Vilella Baixa, la;1;1;;149;64;87;133;16;5;4;124;128
17;Girona;3;Girona;34;Selva;17233;Vilobí d'Onyar;1;1;;725;312;496;600;125;4;18;578;596
17;Girona;3;Girona;34;Selva;17233;Vilobí d'Onyar;1;2;;1631;683;994;1256;375;20;26;1210;1236
8;Barcelona;8;Penedès;3;Alt Penedès;08304;Vilobí del Penedès;1;1;;823;365;516;679;144;9;12;658;670
17;Girona;3;Girona;10;Baix Empordà;17232;Vilopriu;1;1;;160;65;90;112;48;3;9;100;109
25;Lleida;4;Lleida;18;Garrigues;25253;Vilosell, el;1;1;;146;74;99;130;16;1;1;128;129
43;Tarragona;6;Camp de Tarragona;16;Conca de Barberà;43176;Vimbodí i Poblet;1;1;;754;392;502;600;154;27;36;537;573
25;Lleida;4;Lleida;18;Garrigues;25255;Vinaixa;1;1;;391;200;273;323;68;9;21;293;314
43;Tarragona;7;Terres de l'Ebre;30;Ribera d'Ebre;43177;Vinebre;1;1;;285;134;190;230;55;21;15;194;209
43;Tarragona;6;Camp de Tarragona;8;Baix Camp;43178;Vinyols i els Arcs;1;1;;1470;610;891;1087;383;15;16;1056;1072
8;Barcelona;2;Catalunya Central;14;Berguedà;08308;Viver i Serrateix;1;1;;138;52;94;114;24;3;0;111;111
43;Tarragona;7;Terres de l'Ebre;9;Baix Ebre;43052;Xerta;1;1;;949;374;542;663;286;63;63;537;600
